{
    "data": {
        "moves": 36,
        "gems": [
            {
                "type": "coins",
                "amount": 25
            },
            {
                "type": "yellow",
                "amount": 25
            },
            {
                "type": "red",
                "amount": 25
            },
            {
                "type": "blue",
                "amount": 10
            }
        ],
        "objectives": [
            
        ],
        "spawnRatioDroppable": {
            "gemColor": 0,
            "gemType": 0,
            "minSpawn": 0,
            "maxSpawn": 0,
            "probability": 0
        },
        "spawnRatios": [
            
        ],
        "hiddenItemName": "monkey"
    },
    "layout": {
        "fields": [
            1,1,1,1,1,1,1,1,1,
            1,1,1,1,1,1,1,1,1,
            1,2,0,0,0,0,0,2,1,
            1,2,1,1,1,1,1,2,1,
            1,1,1,1,1,1,1,1,1,
            1,2,1,1,1,1,1,2,1,
            1,2,2,2,1,2,2,2,1,
            1,1,1,1,1,1,1,1,1,
            1,1,1,1,1,1,1,1,1
        ],
        "tiles": [
            2,2,2,2,2,2,2,2,2,
            2,2,2,2,2,2,2,2,2,
            0,0,0,0,0,0,0,0,0,
            0,0,2,2,2,2,2,0,0,
            0,0,2,2,2,2,2,0,0,
            0,0,2,2,2,2,2,0,0,
            0,0,0,0,0,0,0,0,0,
            2,2,2,2,2,2,2,2,2,
            2,2,2,2,2,2,2,2,2
        ],
        "stones": [
            0,0,0,0,0,0,0,0,0,
            0,0,0,0,0,0,0,0,0,
            0,0,0,0,0,0,0,0,0,
            0,0,0,0,0,0,0,0,0,
            0,0,0,0,0,0,0,0,0,
            0,0,0,0,0,0,0,0,0,
            0,0,0,0,0,0,0,0,0,
            0,0,0,0,0,0,0,0,0,
            0,0,0,0,0,0,0,0,0
        ],
        "spawning": [
            1,1,1,1,1,1,1,1,1,
            0,0,0,0,0,0,0,0,0,
            0,0,0,0,0,0,0,0,0,
            0,0,1,1,1,1,1,0,0,
            0,0,0,0,0,0,0,0,0,
            0,0,0,0,0,0,0,0,0,
            0,0,0,0,0,0,0,0,0,
            0,0,0,0,0,0,0,0,0,
            0,0,0,0,0,0,0,0,0
        ],
        "dropItems": [
            0,0,0,0,0,0,0,0,0,
            0,0,0,0,0,0,0,0,0,
            0,0,0,0,0,0,0,0,0,
            0,0,0,0,0,0,0,0,0,
            0,0,0,0,0,0,0,0,0,
            0,0,0,0,0,0,0,0,0,
            0,0,0,0,0,0,0,0,0,
            0,0,0,0,0,0,0,0,0,
            0,0,0,0,0,0,0,0,0
        ],
        "chains": [
            0,0,0,0,0,0,0,0,0,
            0,0,0,0,0,0,0,0,0,
            0,0,0,0,0,0,0,0,0,
            0,0,0,0,0,0,0,0,0,
            0,0,0,0,0,0,0,0,0,
            0,0,0,0,0,0,0,0,0,
            0,0,0,0,0,0,0,0,0,
            0,0,0,0,0,0,0,0,0,
            0,0,0,0,0,0,0,0,0
        ],
        "hiddenItems": [
            3,3,0,5,5,0,4,4,0,
            3,3,0,5,5,0,4,4,0,
            0,0,0,0,0,0,0,0,0,
            0,0,7,7,7,8,8,0,0,
            0,0,7,7,7,8,8,0,0,
            0,0,7,7,7,0,0,0,0,
            0,0,0,0,0,0,0,0,0,
            0,2,2,0,6,6,0,1,1,
            0,2,2,0,6,6,0,1,1
        ],
        "gemColors": [
            13,14,13,14,14,13,14,14,13,
            13,14,14,13,14,14,14,13,14,
            14,0,0,0,0,0,0,0,13,
            13,0,8,8,8,8,8,0,14,
            13,13,8,8,8,8,8,13,13,
            13,0,8,8,8,8,8,0,13,
            14,0,0,0,13,0,0,0,14,
            14,14,13,14,13,14,13,14,13,
            13,14,14,14,11,14,14,13,13
        ],
        "gemTypes": [
            0,0,0,0,0,0,0,0,0,
            0,0,0,0,0,0,0,0,0,
            0,0,0,0,0,0,0,0,0,
            0,0,0,0,0,0,0,0,0,
            0,0,0,2,0,2,0,0,0,
            0,0,0,0,0,0,0,0,0,
            0,0,0,0,0,0,0,0,0,
            0,0,0,0,0,0,0,0,0,
            0,0,0,0,0,0,0,0,0
        ],
        "gemModifier": [
            6,5,5,4,4,4,5,5,6,
            5,5,5,4,4,4,5,5,5,
            4,0,0,0,0,0,0,0,4,
            4,0,0,0,0,0,0,0,4,
            6,6,0,0,0,0,0,6,6,
            4,0,0,0,0,0,0,0,4,
            4,0,0,0,4,0,0,0,4,
            5,5,5,4,4,4,5,5,5,
            6,5,5,4,0,4,5,5,6
        ],
        "portals": [
            0,0,0,0,0,0,0,0,0,
            0,0,0,0,0,0,0,0,0,
            0,0,0,0,0,0,0,0,0,
            0,0,0,0,0,0,0,0,0,
            0,0,0,0,0,0,0,0,0,
            0,0,0,0,0,0,0,0,0,
            0,0,0,0,0,0,0,0,0,
            0,0,0,0,0,0,0,0,0,
            0,0,0,0,0,0,0,0,0
        ],
        "crates": [
            0,0,0,0,0,0,0,0,0,
            0,0,0,0,0,0,0,0,0,
            0,0,0,0,0,0,0,0,0,
            0,0,0,0,0,0,0,0,0,
            0,0,0,0,0,0,0,0,0,
            0,0,0,0,0,0,0,0,0,
            0,0,0,0,0,0,0,0,0,
            0,0,0,0,0,0,0,0,0,
            0,0,0,0,0,0,0,0,0
        ],
        "climbers": [
            0,0,0,0,0,0,0,0,0,
            0,0,0,0,0,0,0,0,0,
            0,0,0,0,0,0,0,0,0,
            0,0,0,0,0,0,0,0,0,
            0,0,0,0,0,0,0,0,0,
            0,0,0,0,0,0,0,0,0,
            0,0,0,0,0,0,0,0,0,
            0,0,0,0,0,0,0,0,0,
            0,0,0,0,0,0,0,0,0
        ]
    },
    "collectable": ""
}
