{
    "data": {
        "moves": 35,
        "gems": [
            {
                "type": "coins",
                "amount": 25
            },
            {
                "type": "green",
                "amount": 25
            },
            {
                "type": "orange",
                "amount": 25
            },
            {
                "type": "red",
                "amount": 25
            },
            {
                "type": "purple",
                "amount": 8
            }
        ],
        "objectives": [
            {
                "type": "climber",
                "amount": 2
            }
        ],
        "spawnRatioDroppable": {
            "gemColor": 0,
            "gemType": 0,
            "minSpawn": 0,
            "maxSpawn": 0,
            "probability": 0
        },
        "spawnRatios": [
            {
                "gemColor": 8,
                "gemType": 6,
                "minSpawn": 3,
                "maxSpawn": 5,
                "probability": 4
            }
        ],
        "hiddenItemName": "monkey"
    },
    "layout": {
        "fields": [
            0,1,1,0,0,0,1,1,0,
            1,1,1,1,0,1,1,1,1,
            1,1,1,1,0,1,1,1,1,
            1,1,1,1,0,1,1,1,1,
            1,1,1,1,1,1,1,1,1,
            1,1,1,1,1,1,1,1,1,
            1,1,1,1,1,1,1,1,1,
            1,1,1,1,1,1,1,1,1,
            1,1,1,1,1,1,1,1,1
        ],
        "tiles": [
            0,1,1,0,0,0,1,1,0,
            0,1,1,0,0,0,1,1,0,
            0,2,2,0,0,0,2,2,0,
            0,2,2,0,0,0,2,2,0,
            0,2,2,0,0,0,2,2,0,
            0,2,2,0,0,0,2,2,0,
            0,2,2,1,1,1,2,2,0,
            0,2,2,1,1,1,2,2,0,
            0,0,0,0,0,0,0,0,0
        ],
        "stones": [
            0,3,3,0,0,0,0,0,0,
            2,0,0,2,0,0,0,0,0,
            0,3,3,0,0,0,0,0,0,
            0,3,3,0,0,0,0,0,0,
            2,2,2,1,0,0,0,0,0,
            2,2,1,0,0,0,0,0,0,
            2,1,0,0,0,0,0,0,0,
            1,0,0,0,0,0,0,0,0,
            0,0,0,0,0,0,0,0,0
        ],
        "spawning": [
            0,1,1,0,0,0,1,1,0,
            1,0,0,1,0,1,0,0,1,
            0,0,0,0,0,0,0,0,0,
            0,0,0,0,0,0,0,0,0,
            0,0,0,0,1,0,0,0,0,
            0,0,0,0,0,0,0,0,0,
            0,0,0,0,0,0,0,0,0,
            0,0,0,0,0,0,0,0,0,
            0,0,0,0,0,0,0,0,0
        ],
        "dropItems": [
            0,0,0,0,0,0,0,0,0,
            0,0,0,0,0,0,0,0,0,
            0,0,0,0,0,0,0,0,0,
            0,0,0,0,0,0,0,0,0,
            0,0,0,0,0,0,0,0,0,
            0,0,0,0,0,0,0,0,0,
            0,0,0,0,0,0,0,0,0,
            0,0,0,0,0,0,0,0,0,
            0,0,0,0,0,0,0,0,0
        ],
        "chains": [
            0,0,0,0,0,0,0,0,0,
            0,0,0,0,0,0,0,0,0,
            0,0,0,0,0,0,0,0,0,
            0,0,0,0,0,0,0,0,0,
            0,0,0,0,0,0,0,0,0,
            0,0,0,0,0,0,0,0,0,
            0,0,0,0,0,0,0,0,0,
            0,0,0,0,0,0,0,0,0,
            0,0,0,0,0,0,0,0,0
        ],
        "hiddenItems": [
            0,2,2,0,0,0,1,1,0,
            0,2,2,0,0,0,1,1,0,
            0,8,8,0,0,0,0,0,0,
            0,8,8,0,0,0,0,0,0,
            0,0,0,0,0,0,6,6,0,
            0,0,0,0,0,0,6,6,0,
            0,0,7,7,5,5,4,4,0,
            0,0,7,7,5,5,4,4,0,
            0,0,0,0,0,0,0,0,0
        ],
        "gemColors": [
            0,0,0,0,0,0,8,8,0,
            0,0,0,0,0,8,0,0,8,
            0,0,0,0,0,0,8,8,0,
            0,0,0,0,0,0,8,8,0,
            0,0,0,0,8,8,8,8,8,
            0,0,0,8,8,8,8,8,8,
            0,0,8,8,8,8,8,8,8,
            0,8,8,8,8,8,8,8,8,
            8,8,8,8,8,8,8,12,8
        ],
        "gemTypes": [
            0,0,0,0,0,0,6,6,0,
            0,0,0,0,0,6,0,0,6,
            0,0,0,0,0,0,2,6,0,
            0,0,0,0,0,0,6,2,0,
            0,0,0,0,0,2,6,6,6,
            0,0,0,0,0,0,6,6,2,
            0,0,0,0,0,0,0,6,6,
            0,0,0,0,0,0,0,0,6,
            0,0,0,0,0,0,0,0,0
        ],
        "gemModifier": [
            0,0,0,0,0,0,0,0,0,
            0,0,0,0,0,0,0,0,0,
            0,0,0,0,0,0,0,0,0,
            0,0,0,0,0,0,0,0,0,
            0,0,0,0,0,0,0,0,0,
            0,0,0,0,0,0,0,0,0,
            0,0,0,0,0,0,0,0,0,
            0,0,0,0,0,0,0,0,0,
            0,0,0,0,0,0,0,0,0
        ],
        "portals": [
            0,0,0,0,0,0,0,0,0,
            0,0,0,0,0,0,0,0,0,
            0,0,0,0,0,0,0,0,0,
            0,0,0,0,0,0,0,0,0,
            0,0,0,0,0,0,0,0,0,
            0,0,0,0,0,0,0,0,0,
            0,0,0,0,0,0,0,0,0,
            0,0,0,0,0,0,0,0,0,
            0,0,0,0,0,0,0,0,0
        ],
        "crates": [
            0,0,0,0,0,0,3,3,0,
            0,0,0,0,0,1,0,0,1,
            0,0,0,0,0,0,2,2,0,
            0,0,0,0,0,0,2,2,0,
            0,0,0,0,0,1,1,1,1,
            0,0,0,0,0,0,1,1,1,
            0,0,0,0,0,0,0,1,1,
            0,0,0,0,0,0,0,0,1,
            0,0,0,0,0,0,0,0,0
        ],
        "climbers": [
            0,2,2,0,0,0,2,2,0,
            2,0,0,2,0,2,0,0,2,
            0,0,0,0,0,0,0,0,0,
            0,0,0,0,0,0,0,0,0,
            0,0,0,0,0,0,0,0,0,
            0,0,0,0,0,0,0,0,0,
            0,0,0,0,0,0,0,0,0,
            0,0,0,0,0,0,0,0,0,
            0,1,0,0,0,0,0,0,0
        ]
    },
    "collectable": ""
}
