{
    "data": {
        "moves": 30,
        "gems": [
            {
                "type": "coins",
                "amount": 25
            },
            {
                "type": "red",
                "amount": 25
            },
            {
                "type": "green",
                "amount": 25
            },
            {
                "type": "purple",
                "amount": 15
            }
        ],
        "objectives": [
            
        ],
        "spawnRatioDroppable": {
            "gemColor": 0,
            "gemType": 0,
            "minSpawn": 0,
            "maxSpawn": 0,
            "probability": 0
        },
        "spawnRatios": [
            
        ],
        "hiddenItemName": "monkey"
    },
    "layout": {
        "fields": [
            1,1,0,1,1,1,0,1,1,
            1,1,1,1,1,1,0,1,1,
            1,1,1,1,1,1,0,1,1,
            1,1,0,1,1,1,0,1,1,
            0,0,0,0,1,1,0,0,0,
            1,1,1,0,1,1,1,1,1,
            1,1,1,0,1,1,1,1,1,
            1,1,1,0,1,1,1,1,1,
            1,1,1,0,1,1,1,1,1
        ],
        "tiles": [
            0,0,0,0,0,0,0,2,2,
            0,0,0,0,0,0,0,2,2,
            0,0,0,0,0,0,0,2,2,
            0,0,0,0,0,0,0,2,2,
            0,0,0,0,0,0,0,0,0,
            2,2,2,0,0,0,0,0,0,
            2,2,2,0,0,0,0,0,0,
            2,2,2,0,0,0,0,0,0,
            2,2,2,0,0,0,0,0,0
        ],
        "stones": [
            0,0,0,0,0,0,0,0,0,
            0,0,0,0,0,0,0,0,0,
            0,0,0,0,0,0,0,0,0,
            0,0,0,0,0,0,0,0,0,
            0,0,0,0,0,0,0,0,0,
            0,0,0,0,0,0,0,0,0,
            0,0,0,0,0,0,0,0,0,
            0,0,0,0,0,0,0,0,0,
            0,0,0,0,0,0,0,0,0
        ],
        "spawning": [
            0,0,0,1,1,1,0,1,1,
            0,0,1,0,0,0,0,0,0,
            0,0,0,0,0,0,0,0,0,
            0,0,0,0,0,0,0,0,0,
            0,0,0,0,0,0,0,0,0,
            1,1,1,0,0,0,0,0,0,
            0,0,0,0,0,0,0,0,0,
            0,0,0,0,0,0,0,0,0,
            0,0,0,0,0,0,0,0,0
        ],
        "dropItems": [
            0,0,0,0,0,0,0,0,0,
            0,0,0,0,0,0,0,0,0,
            0,0,0,0,0,0,0,0,0,
            0,0,0,0,0,0,0,0,0,
            0,0,0,0,0,0,0,0,0,
            0,0,0,0,0,0,0,0,0,
            0,0,0,0,0,0,0,0,0,
            0,0,0,0,0,0,0,0,0,
            0,0,0,0,0,0,0,0,0
        ],
        "chains": [
            0,0,0,0,0,0,0,0,0,
            0,0,0,0,0,0,0,0,0,
            0,0,0,0,0,0,0,0,0,
            0,0,0,0,0,0,0,0,0,
            0,0,0,0,0,0,0,0,0,
            0,0,0,0,0,0,0,0,0,
            0,0,0,0,0,0,0,0,0,
            0,0,0,0,0,0,0,0,0,
            0,0,0,0,0,0,0,0,0
        ],
        "hiddenItems": [
            0,0,0,0,0,0,0,0,0,
            0,0,0,0,0,0,0,1,1,
            0,0,0,0,0,0,0,1,1,
            0,0,0,0,0,0,0,0,0,
            0,0,0,0,0,0,0,0,0,
            5,5,0,0,0,0,0,0,0,
            5,5,0,0,0,0,0,0,0,
            0,6,6,0,0,0,0,0,0,
            0,6,6,0,0,0,0,0,0
        ],
        "gemColors": [
            14,14,0,8,8,8,0,10,10,
            13,14,8,8,8,8,0,10,10,
            14,13,8,8,8,8,0,10,10,
            13,14,0,8,8,8,0,10,10,
            0,0,0,0,8,8,0,0,0,
            10,10,10,0,8,8,13,14,13,
            10,10,10,0,8,8,14,13,14,
            10,10,10,0,8,8,14,14,13,
            10,10,10,0,8,8,13,14,14
        ],
        "gemTypes": [
            0,0,0,0,0,0,0,0,0,
            0,0,0,0,0,0,0,0,0,
            0,0,0,0,0,0,0,0,0,
            0,0,0,0,0,0,0,0,0,
            0,0,0,0,0,0,0,0,0,
            0,0,0,0,0,0,0,0,0,
            0,0,0,0,0,0,0,0,0,
            0,0,0,0,0,0,0,0,0,
            0,0,0,0,0,0,0,0,0
        ],
        "gemModifier": [
            5,4,0,0,0,0,0,1,0,
            5,4,0,0,0,0,0,1,0,
            5,4,0,0,0,0,0,1,0,
            5,4,0,0,0,0,0,1,0,
            0,0,0,0,0,0,0,0,0,
            0,1,0,0,0,0,4,5,6,
            0,1,0,0,0,0,4,5,6,
            0,1,0,0,0,0,4,5,6,
            0,1,0,0,0,0,4,5,6
        ],
        "portals": [
            8,10,0,0,0,0,0,0,0,
            0,0,0,0,0,0,0,0,0,
            0,0,0,0,0,0,0,0,0,
            0,0,0,0,0,0,0,7,9,
            0,0,0,0,0,0,0,0,0,
            0,0,0,0,0,0,2,4,6,
            0,0,0,0,0,0,0,0,0,
            0,0,0,0,0,0,0,0,0,
            1,3,5,0,0,0,0,0,0
        ],
        "crates": [
            0,0,0,0,0,0,0,0,0,
            0,0,0,0,0,0,0,0,0,
            0,0,0,0,0,0,0,0,0,
            0,0,0,0,0,0,0,0,0,
            0,0,0,0,0,0,0,0,0,
            0,0,0,0,0,0,0,0,0,
            0,0,0,0,0,0,0,0,0,
            0,0,0,0,0,0,0,0,0,
            0,0,0,0,0,0,0,0,0
        ],
        "climbers": [
            0,0,0,0,0,0,0,0,0,
            0,0,0,0,0,0,0,0,0,
            0,0,0,0,0,0,0,0,0,
            0,0,0,0,0,0,0,0,0,
            0,0,0,0,0,0,0,0,0,
            0,0,0,0,0,0,0,0,0,
            0,0,0,0,0,0,0,0,0,
            0,0,0,0,0,0,0,0,0,
            0,0,0,0,0,0,0,0,0
        ]
    },
    "collectable": ""
}
