{
    "data": {
        "moves": 34,
        "gems": [
            {
                "type": "coins",
                "amount": 25
            },
            {
                "type": "orange",
                "amount": 25
            },
            {
                "type": "red",
                "amount": 25
            },
            {
                "type": "yellow",
                "amount": 25
            },
            {
                "type": "purple",
                "amount": 13
            }
        ],
        "objectives": [
            {
                "type": "climber",
                "amount": 2
            },
            {
                "type": "droppable",
                "amount": 2
            }
        ],
        "spawnRatioDroppable": {
            "gemColor": 7,
            "gemType": 0,
            "minSpawn": 1,
            "maxSpawn": 2,
            "probability": 6
        },
        "spawnRatios": [
            {
                "gemColor": 8,
                "gemType": 6,
                "minSpawn": 3,
                "maxSpawn": 7,
                "probability": 5
            }
        ],
        "hiddenItemName": "monkey"
    },
    "layout": {
        "fields": [
            1,0,1,0,1,1,0,1,1,
            1,0,1,0,1,1,1,1,1,
            1,0,1,0,1,1,1,1,1,
            1,0,1,0,1,1,1,1,1,
            0,0,0,0,1,1,1,1,1,
            1,0,1,0,1,1,1,1,1,
            1,0,1,0,1,1,1,1,1,
            1,0,1,0,1,1,1,1,1,
            1,0,1,0,1,1,1,1,1
        ],
        "tiles": [
            0,0,0,0,0,0,0,0,0,
            0,0,0,0,0,0,0,0,0,
            0,0,0,0,0,0,0,0,0,
            0,0,0,0,0,0,0,0,0,
            0,0,0,0,0,0,0,0,0,
            0,0,0,0,0,0,0,0,0,
            0,0,0,0,0,0,0,0,0,
            0,0,0,0,0,0,0,0,0,
            0,0,0,0,0,0,0,0,0
        ],
        "stones": [
            0,0,0,0,0,0,0,0,0,
            0,0,0,0,0,0,0,0,0,
            0,0,0,0,0,0,0,0,0,
            0,0,0,0,0,0,0,0,0,
            0,0,0,0,0,0,0,0,0,
            0,0,0,0,0,0,0,0,0,
            0,0,0,0,0,0,0,0,0,
            0,0,0,0,0,0,0,0,0,
            0,0,0,0,0,0,0,0,0
        ],
        "spawning": [
            0,0,1,0,0,0,0,0,0,
            0,0,0,0,0,0,1,0,0,
            0,0,0,0,0,0,0,0,0,
            0,0,0,0,0,0,0,0,0,
            0,0,0,0,0,0,0,0,0,
            1,0,0,0,0,0,0,0,0,
            0,0,0,0,0,0,0,0,0,
            0,0,0,0,0,0,0,0,0,
            0,0,0,0,0,0,0,0,0
        ],
        "dropItems": [
            1,0,0,0,0,0,0,0,0,
            0,0,0,0,0,0,0,0,0,
            0,0,0,0,0,0,0,0,0,
            0,0,0,0,0,0,0,0,0,
            0,0,0,0,0,0,0,0,0,
            0,0,1,0,0,0,0,0,0,
            0,0,0,0,0,0,0,0,0,
            0,0,0,0,0,0,0,0,0,
            0,0,0,0,2,2,2,2,2
        ],
        "chains": [
            0,0,0,0,0,0,0,0,0,
            0,0,0,0,0,0,0,0,0,
            1,0,0,0,0,0,0,0,0,
            0,0,0,0,0,0,3,0,0,
            0,0,0,0,3,0,0,0,3,
            0,0,0,0,0,0,3,0,0,
            0,0,0,0,0,0,0,0,0,
            0,0,1,0,0,0,0,0,0,
            0,0,0,0,0,0,0,0,0
        ],
        "hiddenItems": [
            0,0,0,0,0,0,0,0,0,
            0,0,0,0,0,0,0,0,0,
            0,0,0,0,0,0,0,0,0,
            0,0,0,0,0,0,0,0,0,
            0,0,0,0,0,0,0,0,0,
            0,0,0,0,0,0,0,0,0,
            0,0,0,0,0,0,0,0,0,
            0,0,0,0,0,0,0,0,0,
            0,0,0,0,0,0,0,0,0
        ],
        "gemColors": [
            7,0,8,0,0,8,0,8,0,
            8,0,8,0,8,8,8,8,8,
            8,0,8,0,8,8,8,8,8,
            8,0,8,0,8,8,8,8,8,
            0,0,0,0,8,8,4,8,8,
            8,0,7,0,8,8,8,8,8,
            8,0,8,0,8,8,4,8,8,
            8,0,8,0,8,8,8,8,8,
            4,0,8,0,12,8,8,8,8
        ],
        "gemTypes": [
            0,0,1,0,0,0,0,0,0,
            0,0,0,0,0,0,0,0,0,
            6,0,6,0,0,0,6,0,0,
            0,0,6,0,0,0,6,0,0,
            0,0,0,0,6,6,10,6,6,
            3,0,0,0,0,0,6,0,0,
            0,0,0,0,0,0,7,0,0,
            6,0,6,0,0,0,0,0,0,
            7,0,0,0,0,0,0,0,0
        ],
        "gemModifier": [
            0,0,2,0,0,0,0,0,0,
            0,0,1,0,0,0,0,0,0,
            0,0,2,0,0,0,2,0,0,
            0,0,0,0,0,0,0,0,0,
            0,0,0,0,0,2,8,2,0,
            2,0,0,0,0,0,0,0,0,
            1,0,0,0,0,0,2,0,0,
            2,0,0,0,0,0,0,0,0,
            0,0,0,0,0,0,0,0,0
        ],
        "portals": [
            0,0,0,0,2,4,0,6,8,
            0,0,0,0,0,0,0,0,0,
            0,0,0,0,0,0,0,0,0,
            1,0,3,0,0,0,0,0,0,
            0,0,0,0,0,0,0,0,0,
            0,0,0,0,0,0,0,0,0,
            0,0,0,0,0,0,0,0,0,
            0,0,0,0,0,0,0,0,0,
            5,0,7,0,0,0,0,0,0
        ],
        "crates": [
            0,0,0,0,0,0,0,0,0,
            0,0,0,0,0,0,0,0,0,
            0,0,0,0,0,0,0,0,0,
            0,0,0,0,0,0,0,0,0,
            0,0,0,0,0,0,0,0,0,
            0,0,0,0,0,0,0,0,0,
            0,0,0,0,0,0,0,0,0,
            0,0,0,0,0,0,0,0,0,
            0,0,0,0,0,0,0,0,0
        ],
        "climbers": [
            2,0,2,0,0,0,0,0,0,
            0,0,0,0,0,0,2,0,0,
            0,0,0,0,0,0,0,0,0,
            0,0,0,0,0,0,0,0,0,
            0,0,0,0,0,0,0,0,0,
            2,0,2,0,0,0,0,0,0,
            0,0,0,0,0,0,0,0,0,
            0,0,0,0,0,0,0,0,0,
            0,0,0,0,1,0,0,0,1
        ]
    },
    "collectable": ""
}
