{
    "data": {
        "moves": 41,
        "gems": [
            {
                "type": "coins",
                "amount": 25
            },
            {
                "type": "yellow",
                "amount": 25
            },
            {
                "type": "orange",
                "amount": 25
            },
            {
                "type": "red",
                "amount": 25
            },
            {
                "type": "purple",
                "amount": 25
            },
            {
                "type": "green",
                "amount": 9
            }
        ],
        "objectives": [
            
        ],
        "spawnRatioDroppable": {
            "gemColor": 0,
            "gemType": 0,
            "minSpawn": 0,
            "maxSpawn": 0,
            "probability": 0
        },
        "spawnRatios": [
            {
                "gemColor": 8,
                "gemType": 1,
                "minSpawn": 1,
                "maxSpawn": 3,
                "probability": 1
            }
        ],
        "hiddenItemName": "monkey"
    },
    "layout": {
        "fields": [
            1,1,0,1,1,1,1,1,1,
            1,1,0,1,1,1,1,1,1,
            1,1,0,1,1,1,1,1,1,
            1,1,0,1,1,1,1,1,1,
            1,1,0,1,1,1,1,1,1,
            1,1,0,1,1,1,1,1,1,
            1,1,0,1,1,1,1,1,1,
            1,1,0,1,1,1,1,1,1,
            1,1,0,1,1,1,1,1,1
        ],
        "tiles": [
            0,0,0,0,0,0,0,0,0,
            0,0,0,0,0,0,0,0,0,
            0,0,0,0,0,0,0,0,0,
            0,0,0,0,0,0,0,0,0,
            0,0,0,0,0,0,0,0,0,
            0,0,0,0,0,0,0,0,0,
            0,0,0,0,0,0,0,0,0,
            0,0,0,0,0,0,0,0,0,
            0,0,0,0,0,0,0,0,0
        ],
        "stones": [
            0,8,0,0,0,0,0,0,0,
            8,0,0,0,0,0,0,0,0,
            0,8,0,0,0,0,0,0,0,
            8,0,0,0,0,0,0,0,0,
            0,8,0,0,0,0,0,0,0,
            8,0,0,0,0,0,0,0,0,
            0,8,0,0,0,0,0,0,0,
            8,0,0,0,0,0,0,0,0,
            0,8,0,0,0,0,0,0,0
        ],
        "spawning": [
            1,1,0,0,1,1,1,1,0,
            0,0,0,0,0,0,0,0,0,
            0,0,0,0,0,0,0,0,0,
            0,0,0,0,0,0,0,0,0,
            0,0,0,0,0,0,0,0,0,
            0,0,0,0,0,0,0,0,0,
            0,0,0,0,0,0,0,0,0,
            0,0,0,0,0,0,0,0,0,
            0,0,0,0,0,0,0,0,0
        ],
        "dropItems": [
            0,0,0,0,0,0,0,0,0,
            0,0,0,0,0,0,0,0,0,
            0,0,0,0,0,0,0,0,0,
            0,0,0,0,0,0,0,0,0,
            0,0,0,0,0,0,0,0,0,
            0,0,0,0,0,0,0,0,0,
            0,0,0,0,0,0,0,0,0,
            0,0,0,0,0,0,0,0,0,
            0,0,0,0,0,0,0,0,0
        ],
        "chains": [
            0,0,0,3,2,3,2,0,0,
            0,0,0,2,1,2,1,0,0,
            0,0,0,3,2,3,2,0,0,
            0,0,0,2,1,2,1,0,0,
            0,0,0,3,2,3,2,0,0,
            0,0,0,2,1,2,1,0,0,
            0,0,0,3,2,3,2,0,0,
            0,0,0,2,1,2,1,0,0,
            0,0,0,3,2,3,2,0,0
        ],
        "hiddenItems": [
            0,0,0,0,0,0,0,0,0,
            0,0,0,0,0,0,0,0,0,
            0,0,0,0,0,0,0,0,0,
            0,0,0,0,0,0,0,0,0,
            0,0,0,0,0,0,0,0,0,
            0,0,0,0,0,0,0,0,0,
            0,0,0,0,0,0,0,0,0,
            0,0,0,0,0,0,0,0,0,
            0,0,0,0,0,0,0,0,0
        ],
        "gemColors": [
            8,0,0,8,8,8,8,8,8,
            0,8,0,8,8,8,8,8,8,
            8,0,0,8,8,8,8,8,8,
            0,8,0,8,8,8,8,8,8,
            8,0,0,8,8,8,8,8,8,
            0,8,0,8,8,8,8,8,8,
            8,0,0,8,8,8,8,8,8,
            0,8,0,8,8,8,8,8,8,
            8,0,0,8,8,8,8,8,8
        ],
        "gemTypes": [
            0,0,0,1,1,0,1,0,0,
            0,0,0,1,1,1,0,0,0,
            0,0,0,1,1,1,1,0,0,
            0,0,0,1,0,1,0,0,0,
            0,0,0,0,1,0,1,0,0,
            0,0,0,1,0,1,0,0,0,
            0,0,0,0,1,1,1,0,0,
            0,0,0,1,0,1,0,0,0,
            0,0,0,1,1,0,1,0,0
        ],
        "gemModifier": [
            0,0,0,0,0,0,0,0,0,
            0,0,0,0,0,0,0,0,0,
            0,0,0,0,0,0,0,0,0,
            0,0,0,0,0,0,0,0,0,
            0,0,0,0,0,0,0,0,0,
            0,0,0,0,0,0,0,0,0,
            0,0,0,0,0,0,0,0,0,
            0,0,0,0,0,0,0,0,0,
            0,0,0,0,0,0,0,0,0
        ],
        "portals": [
            0,0,0,4,0,0,0,0,2,
            0,0,0,0,0,0,0,0,0,
            0,0,0,0,0,0,0,0,0,
            0,0,0,0,0,0,0,0,0,
            0,0,0,0,0,0,0,0,0,
            0,0,0,0,0,0,0,0,0,
            0,0,0,0,0,0,0,0,0,
            0,0,0,0,0,0,0,0,0,
            0,0,0,0,0,0,0,1,3
        ],
        "crates": [
            0,0,0,0,0,0,0,0,0,
            0,0,0,0,0,0,0,0,0,
            0,0,0,0,0,0,0,0,0,
            0,0,0,0,0,0,0,0,0,
            0,0,0,0,0,0,0,0,0,
            0,0,0,0,0,0,0,0,0,
            0,0,0,0,0,0,0,0,0,
            0,0,0,0,0,0,0,0,0,
            0,0,0,0,0,0,0,0,0
        ],
        "climbers": [
            0,0,0,0,0,0,0,0,0,
            0,0,0,0,0,0,0,0,0,
            0,0,0,0,0,0,0,0,0,
            0,0,0,0,0,0,0,0,0,
            0,0,0,0,0,0,0,0,0,
            0,0,0,0,0,0,0,0,0,
            0,0,0,0,0,0,0,0,0,
            0,0,0,0,0,0,0,0,0,
            0,0,0,0,0,0,0,0,0
        ]
    },
    "collectable": ""
}
