{
    "data": {
        "moves": 35,
        "gems": [
            {
                "type": "coins",
                "amount": 25
            },
            {
                "type": "blue",
                "amount": 25
            },
            {
                "type": "orange",
                "amount": 25
            },
            {
                "type": "red",
                "amount": 25
            },
            {
                "type": "purple",
                "amount": 20
            }
        ],
        "objectives": [
            
        ],
        "spawnRatioDroppable": {
            "gemColor": 0,
            "gemType": 0,
            "minSpawn": 0,
            "maxSpawn": 0,
            "probability": 0
        },
        "spawnRatios": [
            
        ],
        "hiddenItemName": "monkey"
    },
    "layout": {
        "fields": [
            1,1,1,1,1,1,1,1,1,
            1,1,1,1,1,1,1,1,1,
            1,1,0,0,0,1,1,1,1,
            1,1,0,1,1,1,1,1,1,
            1,1,0,0,0,0,0,1,1,
            1,1,1,1,1,1,0,1,1,
            1,1,1,1,0,0,0,1,1,
            1,1,1,1,1,1,1,1,1,
            1,1,1,1,1,1,1,1,1
        ],
        "tiles": [
            1,1,2,2,2,0,0,1,1,
            1,1,2,2,2,0,0,1,1,
            1,1,0,0,0,0,0,1,1,
            1,1,0,0,0,0,0,1,1,
            1,1,0,0,0,0,0,1,1,
            1,1,0,0,0,0,0,1,1,
            1,1,0,0,0,0,0,1,1,
            1,1,0,0,2,2,2,1,1,
            1,1,0,0,2,2,2,1,1
        ],
        "stones": [
            0,0,0,0,0,0,0,0,0,
            0,0,0,0,0,0,0,0,0,
            0,0,0,0,0,0,0,0,0,
            0,0,0,8,0,0,0,0,0,
            0,0,0,0,0,0,0,0,0,
            0,0,0,0,0,8,0,0,0,
            0,0,0,0,0,0,0,0,0,
            0,0,0,0,0,0,0,0,0,
            0,0,0,0,0,0,0,0,0
        ],
        "spawning": [
            0,0,1,1,1,0,0,1,1,
            0,0,0,0,0,0,0,0,0,
            0,0,0,0,0,0,0,0,0,
            0,0,0,1,1,0,0,0,0,
            0,0,0,0,0,0,0,0,0,
            0,0,0,0,1,1,0,0,0,
            0,0,0,0,0,0,0,0,0,
            0,0,0,0,1,1,1,0,0,
            0,0,0,0,0,0,0,0,0
        ],
        "dropItems": [
            0,0,0,0,0,0,0,0,0,
            0,0,0,0,0,0,0,0,0,
            0,0,0,0,0,0,0,0,0,
            0,0,0,0,0,0,0,0,0,
            0,0,0,0,0,0,0,0,0,
            0,0,0,0,0,0,0,0,0,
            0,0,0,0,0,0,0,0,0,
            0,0,0,0,0,0,0,0,0,
            0,0,0,0,0,0,0,0,0
        ],
        "chains": [
            0,0,0,0,0,0,0,0,0,
            0,0,0,0,0,0,0,0,0,
            0,0,0,0,0,0,0,0,0,
            0,0,0,0,0,0,0,0,0,
            0,0,0,0,0,0,0,0,0,
            0,0,0,0,0,0,0,0,0,
            0,0,0,0,0,0,0,0,0,
            0,0,0,0,0,0,0,0,0,
            0,0,0,0,0,0,0,0,0
        ],
        "hiddenItems": [
            2,2,0,3,3,0,0,5,5,
            2,2,0,3,3,0,0,5,5,
            0,0,0,0,0,0,0,6,6,
            0,0,0,0,0,0,0,6,6,
            0,0,0,0,0,0,0,0,0,
            0,0,0,0,0,0,0,7,7,
            0,0,0,0,0,0,0,7,7,
            1,1,0,0,4,4,0,8,8,
            1,1,0,0,4,4,0,8,8
        ],
        "gemColors": [
            6,5,8,8,8,6,5,10,10,
            8,8,8,8,8,5,6,10,10,
            8,8,0,0,0,6,5,10,10,
            8,8,0,0,10,5,6,10,10,
            8,8,0,0,0,0,0,10,10,
            8,8,9,1,10,0,0,10,10,
            8,8,1,9,0,0,0,10,10,
            8,8,5,6,8,8,8,1,9,
            8,8,6,5,8,8,8,9,1
        ],
        "gemTypes": [
            0,0,0,0,0,0,0,0,0,
            0,0,0,0,0,0,0,0,0,
            0,0,0,0,0,0,0,0,0,
            0,0,0,0,0,0,0,0,0,
            0,0,0,0,0,0,0,0,0,
            0,0,0,0,0,0,0,0,0,
            0,0,0,0,0,0,0,0,0,
            0,0,0,0,0,0,0,0,0,
            0,0,0,0,0,0,0,0,0
        ],
        "gemModifier": [
            1,1,0,0,0,1,1,0,0,
            0,0,0,0,0,1,1,0,0,
            0,0,0,0,0,1,1,0,0,
            0,0,0,0,0,1,1,0,0,
            0,0,0,0,0,0,0,0,0,
            0,0,2,2,0,0,0,0,0,
            0,0,2,2,0,0,0,0,0,
            0,0,1,1,0,0,0,2,2,
            0,0,1,1,0,0,0,2,2
        ],
        "portals": [
            10,12,0,0,0,6,8,0,0,
            0,0,0,0,0,0,0,0,0,
            0,0,0,0,0,0,0,0,0,
            0,0,0,0,0,9,11,0,0,
            0,0,0,0,0,0,0,0,0,
            0,0,2,4,0,0,0,0,0,
            0,0,0,0,0,0,0,0,0,
            0,0,0,0,0,0,0,0,0,
            0,0,5,7,0,0,0,1,3
        ],
        "crates": [
            0,0,0,0,0,0,0,0,0,
            0,0,0,0,0,0,0,0,0,
            0,0,0,0,0,0,0,0,0,
            0,0,0,0,0,0,0,0,0,
            0,0,0,0,0,0,0,0,0,
            0,0,0,0,0,0,0,0,0,
            0,0,0,0,0,0,0,0,0,
            0,0,0,0,0,0,0,0,0,
            0,0,0,0,0,0,0,0,0
        ],
        "climbers": [
            0,0,0,0,0,0,0,0,0,
            0,0,0,0,0,0,0,0,0,
            0,0,0,0,0,0,0,0,0,
            0,0,0,0,0,0,0,0,0,
            0,0,0,0,0,0,0,0,0,
            0,0,0,0,0,0,0,0,0,
            0,0,0,0,0,0,0,0,0,
            0,0,0,0,0,0,0,0,0,
            0,0,0,0,0,0,0,0,0
        ]
    },
    "collectable": ""
}
