{
    "data": {
        "moves": 34,
        "gems": [
            {
                "type": "coins",
                "amount": 25
            },
            {
                "type": "blue",
                "amount": 25
            },
            {
                "type": "orange",
                "amount": 25
            },
            {
                "type": "red",
                "amount": 25
            },
            {
                "type": "purple",
                "amount": 9
            }
        ],
        "objectives": [
            {
                "type": "climber",
                "amount": 3
            }
        ],
        "spawnRatioDroppable": {
            "gemColor": 0,
            "gemType": 0,
            "minSpawn": 0,
            "maxSpawn": 0,
            "probability": 0
        },
        "spawnRatios": [
            
        ],
        "hiddenItemName": "monkey"
    },
    "layout": {
        "fields": [
            1,1,1,1,1,1,1,1,1,
            0,0,0,1,1,0,1,1,1,
            1,1,1,1,1,1,1,1,1,
            0,0,0,1,1,0,1,1,1,
            1,1,1,1,1,0,1,1,1,
            0,0,0,1,1,0,1,1,1,
            1,1,1,1,1,1,1,1,1,
            0,0,0,1,1,0,1,1,1,
            1,1,1,1,1,1,1,1,1
        ],
        "tiles": [
            0,0,0,0,0,0,0,0,0,
            0,0,0,0,0,0,0,0,0,
            0,0,0,0,0,0,0,0,0,
            0,0,0,0,0,0,0,0,0,
            0,0,0,0,0,0,0,0,0,
            0,0,0,0,0,0,0,0,0,
            0,0,0,0,0,0,0,0,0,
            0,0,0,0,0,0,0,0,0,
            0,0,0,0,0,0,0,0,0
        ],
        "stones": [
            0,0,0,0,0,0,0,0,0,
            0,0,0,0,0,0,0,0,0,
            0,0,0,0,0,0,0,0,0,
            0,0,0,0,0,0,0,0,0,
            0,0,0,0,0,0,0,0,0,
            0,0,0,0,0,0,0,0,0,
            0,0,0,0,0,0,0,0,0,
            0,0,0,0,0,0,0,0,0,
            0,0,0,0,0,0,0,0,0
        ],
        "spawning": [
            2,2,1,1,1,1,1,1,1,
            0,0,0,0,0,0,0,0,0,
            2,2,1,0,0,0,0,0,0,
            0,0,0,0,0,0,0,0,0,
            2,2,1,0,0,0,0,0,0,
            0,0,0,0,0,0,0,0,0,
            2,2,1,0,0,0,0,0,0,
            0,0,0,0,0,0,0,0,0,
            2,2,1,0,0,0,0,0,0
        ],
        "dropItems": [
            0,0,0,0,0,0,0,0,0,
            0,0,0,0,0,0,0,0,0,
            0,0,0,0,0,0,0,0,0,
            0,0,0,0,0,0,0,0,0,
            0,0,0,0,0,0,0,0,0,
            0,0,0,0,0,0,0,0,0,
            0,0,0,0,0,0,0,0,0,
            0,0,0,0,0,0,0,0,0,
            0,0,0,0,0,0,0,0,0
        ],
        "chains": [
            0,0,1,0,0,1,0,3,0,
            0,0,0,0,0,0,3,0,3,
            0,0,2,0,0,1,0,3,0,
            0,0,0,0,0,0,3,0,3,
            0,0,2,0,0,0,0,3,0,
            0,0,0,0,0,0,3,0,3,
            0,0,2,0,0,1,0,3,0,
            0,0,0,0,0,0,3,0,3,
            0,0,1,0,0,1,0,3,0
        ],
        "hiddenItems": [
            0,0,0,0,0,0,0,0,0,
            0,0,0,0,0,0,0,0,0,
            0,0,0,0,0,0,0,0,0,
            0,0,0,0,0,0,0,0,0,
            0,0,0,0,0,0,0,0,0,
            0,0,0,0,0,0,0,0,0,
            0,0,0,0,0,0,0,0,0,
            0,0,0,0,0,0,0,0,0,
            0,0,0,0,0,0,0,0,0
        ],
        "gemColors": [
            9,9,8,8,8,8,8,8,8,
            0,0,0,8,8,0,8,8,8,
            3,3,8,8,8,8,8,8,8,
            0,0,0,8,8,0,8,8,8,
            6,6,8,8,8,0,8,8,8,
            0,0,0,8,8,0,8,8,8,
            1,1,8,8,8,8,8,8,8,
            0,0,0,8,8,0,8,8,8,
            5,5,8,8,8,8,8,8,12
        ],
        "gemTypes": [
            6,0,0,0,0,1,0,1,0,
            0,0,0,0,0,0,0,0,0,
            6,0,0,0,0,0,0,0,0,
            0,0,0,0,0,0,1,0,1,
            6,0,0,0,0,0,0,1,0,
            0,0,0,0,0,0,0,0,0,
            6,0,0,0,0,1,0,0,0,
            0,0,0,0,0,0,1,0,1,
            6,0,0,0,0,0,0,1,0
        ],
        "gemModifier": [
            0,0,0,0,0,0,0,0,0,
            0,0,0,0,0,0,0,0,0,
            0,0,0,0,0,0,0,0,0,
            0,0,0,0,0,0,0,0,0,
            0,0,0,0,0,0,0,0,0,
            0,0,0,0,0,0,0,0,0,
            0,0,0,0,0,0,0,0,0,
            0,0,0,0,0,0,0,0,0,
            0,0,0,0,0,0,0,0,0
        ],
        "portals": [
            0,0,0,0,0,0,0,0,0,
            0,0,0,0,0,0,0,0,0,
            0,0,0,0,0,0,0,0,0,
            0,0,0,0,0,0,0,0,0,
            0,0,0,0,0,0,0,0,0,
            0,0,0,0,0,0,0,0,0,
            0,0,0,0,0,0,0,0,0,
            0,0,0,0,0,0,0,0,0,
            0,0,0,0,0,0,0,0,0
        ],
        "crates": [
            0,0,0,0,0,0,0,0,0,
            0,0,0,0,0,0,0,0,0,
            0,0,0,0,0,0,0,0,0,
            0,0,0,0,0,0,0,0,0,
            0,0,0,0,0,0,0,0,0,
            0,0,0,0,0,0,0,0,0,
            0,0,0,0,0,0,0,0,0,
            0,0,0,0,0,0,0,0,0,
            0,0,0,0,0,0,0,0,0
        ],
        "climbers": [
            0,0,2,2,2,2,2,2,2,
            0,0,0,0,0,0,0,0,0,
            0,0,0,0,0,0,0,0,0,
            0,0,0,0,0,0,0,0,0,
            0,0,0,0,0,0,0,0,0,
            0,0,0,0,0,0,0,0,0,
            0,0,0,0,0,0,0,0,0,
            0,0,0,0,0,0,0,0,0,
            0,0,0,0,0,0,0,1,0
        ]
    },
    "collectable": ""
}
