{
    "data": {
        "moves": 35,
        "gems": [
            {
                "type": "coins",
                "amount": 25
            },
            {
                "type": "red",
                "amount": 25
            },
            {
                "type": "orange",
                "amount": 25
            },
            {
                "type": "yellow",
                "amount": 25
            },
            {
                "type": "purple",
                "amount": 11
            }
        ],
        "objectives": [
            {
                "type": "climber",
                "amount": 3
            }
        ],
        "spawnRatioDroppable": {
            "gemColor": 0,
            "gemType": 0,
            "minSpawn": 0,
            "maxSpawn": 0,
            "probability": 0
        },
        "spawnRatios": [
            {
                "gemColor": 8,
                "gemType": 6,
                "minSpawn": 2,
                "maxSpawn": 4,
                "probability": 5
            }
        ],
        "hiddenItemName": "monkey"
    },
    "layout": {
        "fields": [
            1,1,1,1,1,1,1,1,1,
            1,1,1,1,1,1,0,1,0,
            1,0,1,0,1,0,1,1,1,
            1,1,1,1,1,1,0,1,0,
            1,1,1,1,1,0,1,1,1,
            1,1,1,1,1,1,0,1,0,
            1,1,1,1,1,0,1,1,1,
            1,1,1,1,1,1,0,1,0,
            1,1,1,1,1,0,1,1,1
        ],
        "tiles": [
            0,0,0,0,0,0,0,0,0,
            0,0,0,0,0,0,0,0,0,
            0,0,0,0,0,0,0,0,0,
            0,0,0,0,0,0,0,0,0,
            0,0,0,0,0,0,0,0,0,
            0,0,0,0,0,0,0,0,0,
            0,0,0,0,0,0,0,0,0,
            0,0,0,0,0,0,0,0,0,
            0,0,0,0,0,0,0,0,0
        ],
        "stones": [
            0,0,0,0,0,0,0,0,0,
            0,0,0,0,0,0,0,0,0,
            0,0,0,0,0,0,0,0,0,
            0,0,0,0,0,0,0,0,0,
            0,0,0,0,0,0,0,0,0,
            0,0,0,0,0,0,0,0,0,
            0,0,0,0,0,0,0,0,0,
            0,0,0,0,0,0,0,0,0,
            0,0,0,0,0,0,0,0,0
        ],
        "spawning": [
            1,1,1,1,1,1,1,1,1,
            0,0,0,0,0,0,0,0,0,
            0,0,0,0,0,0,0,0,0,
            0,0,0,0,0,0,0,0,0,
            0,0,0,0,0,0,0,0,0,
            0,0,0,0,0,0,0,0,0,
            0,0,0,0,0,0,0,0,0,
            0,0,0,0,0,0,0,0,0,
            0,0,0,0,0,0,0,0,0
        ],
        "dropItems": [
            0,0,0,0,0,0,0,0,0,
            0,0,0,0,0,0,0,0,0,
            0,0,0,0,0,0,0,0,0,
            0,0,0,0,0,0,0,0,0,
            0,0,0,0,0,0,0,0,0,
            0,0,0,0,0,0,0,0,0,
            0,0,0,0,0,0,0,0,0,
            0,0,0,0,0,0,0,0,0,
            0,0,0,0,0,0,0,0,0
        ],
        "chains": [
            0,0,0,0,0,0,0,0,0,
            0,0,0,0,0,0,0,0,0,
            0,0,0,0,0,0,0,0,0,
            0,0,0,0,0,0,0,0,0,
            0,0,0,0,0,0,0,0,0,
            0,0,0,0,0,0,0,0,0,
            0,0,0,0,0,0,0,0,0,
            0,0,0,0,0,0,0,0,0,
            0,0,0,0,0,0,0,0,0
        ],
        "hiddenItems": [
            0,0,0,0,0,0,0,0,0,
            0,0,0,0,0,0,0,0,0,
            0,0,0,0,0,0,0,0,0,
            0,0,0,0,0,0,0,0,0,
            0,0,0,0,0,0,0,0,0,
            0,0,0,0,0,0,0,0,0,
            0,0,0,0,0,0,0,0,0,
            0,0,0,0,0,0,0,0,0,
            0,0,0,0,0,0,0,0,0
        ],
        "gemColors": [
            8,8,8,8,8,8,4,1,4,
            8,8,8,8,8,8,0,8,0,
            8,0,8,0,8,0,1,1,1,
            8,8,8,8,8,8,0,8,0,
            8,8,8,8,8,0,1,1,1,
            8,8,8,8,8,8,0,8,0,
            8,8,8,8,8,0,1,1,1,
            8,8,8,8,8,8,0,8,0,
            8,8,8,8,8,0,1,12,1
        ],
        "gemTypes": [
            6,6,6,6,6,6,6,0,6,
            0,6,0,6,0,0,0,0,0,
            0,0,0,0,0,0,6,0,6,
            0,6,0,1,0,0,0,0,0,
            0,0,0,0,0,0,6,0,6,
            0,1,0,6,0,0,0,0,0,
            0,0,0,0,0,0,6,0,6,
            0,6,0,1,0,0,0,0,0,
            0,0,0,0,0,0,6,0,6
        ],
        "gemModifier": [
            1,0,2,0,1,0,0,0,0,
            0,3,0,3,0,0,0,0,0,
            0,0,0,0,0,0,1,0,1,
            0,0,0,0,0,0,0,0,0,
            0,0,0,0,0,0,1,0,2,
            0,0,0,0,0,0,0,0,0,
            0,0,0,0,0,0,1,0,1,
            0,0,0,0,0,0,0,0,0,
            0,0,0,0,0,0,1,0,2
        ],
        "portals": [
            0,0,0,0,0,0,0,0,0,
            0,0,0,0,0,0,0,0,0,
            0,0,0,0,0,0,0,0,0,
            0,0,0,0,0,0,0,0,0,
            0,0,0,0,0,0,0,0,0,
            0,0,0,0,0,0,0,0,0,
            0,0,0,0,0,0,0,0,0,
            0,0,0,0,0,0,0,0,0,
            0,0,0,0,0,0,0,0,0
        ],
        "crates": [
            0,5,0,5,0,5,5,5,5,
            5,0,5,0,5,0,0,6,0,
            0,0,0,0,0,0,0,5,0,
            0,5,0,6,0,0,0,6,0,
            0,0,0,0,0,0,0,5,0,
            0,6,0,5,0,0,0,6,0,
            0,0,0,0,0,0,0,5,0,
            0,5,0,6,0,0,0,6,0,
            0,0,0,0,0,0,0,0,0
        ],
        "climbers": [
            0,0,0,0,0,2,2,2,2,
            0,0,0,0,0,0,0,0,0,
            0,0,0,0,0,0,2,0,2,
            0,0,0,0,0,0,0,0,0,
            0,0,0,0,0,0,2,0,2,
            0,0,0,0,0,0,0,0,0,
            0,0,0,0,0,0,2,0,2,
            0,0,0,0,0,0,0,0,0,
            0,0,0,0,0,0,2,1,2
        ]
    },
    "collectable": ""
}
