{
    "data": {
        "moves": 34,
        "gems": [
            {
                "type": "coins",
                "amount": 25
            },
            {
                "type": "green",
                "amount": 25
            },
            {
                "type": "orange",
                "amount": 25
            },
            {
                "type": "red",
                "amount": 25
            },
            {
                "type": "yellow",
                "amount": 10
            }
        ],
        "objectives": [
            {
                "type": "red",
                "amount": 140
            },
            {
                "type": "coins",
                "amount": 70
            }
        ],
        "spawnRatioDroppable": {
            "gemColor": 0,
            "gemType": 0,
            "minSpawn": 0,
            "maxSpawn": 0,
            "probability": 0
        },
        "spawnRatios": [
            
        ],
        "hiddenItemName": "monkey"
    },
    "layout": {
        "fields": [
            1,1,1,1,0,1,1,1,1,
            1,1,1,1,0,1,1,1,1,
            1,1,1,0,0,1,1,1,1,
            1,1,0,0,1,1,1,1,1,
            1,1,0,1,1,1,0,1,1,
            1,1,1,1,1,0,0,1,1,
            1,1,1,1,0,0,1,1,1,
            1,1,1,1,0,1,1,1,1,
            1,1,1,1,0,1,1,1,1
        ],
        "tiles": [
            0,0,0,0,0,0,0,0,0,
            0,0,0,0,0,0,0,0,0,
            0,0,0,0,0,0,0,0,0,
            0,0,0,0,0,0,0,0,0,
            0,0,0,0,0,0,0,0,0,
            0,0,0,0,0,0,0,0,0,
            0,0,0,0,0,0,0,0,0,
            0,0,0,0,0,0,0,0,0,
            0,0,0,0,0,0,0,0,0
        ],
        "stones": [
            0,0,0,0,0,0,0,0,0,
            0,0,0,0,0,0,0,0,0,
            0,0,0,0,0,0,0,0,0,
            0,0,0,0,0,0,0,0,0,
            0,0,0,0,0,0,0,0,0,
            0,0,0,0,0,0,0,0,0,
            0,0,0,0,0,0,0,0,0,
            0,0,0,0,0,0,0,0,0,
            0,0,0,0,0,0,0,0,0
        ],
        "spawning": [
            1,1,1,1,0,0,0,0,0,
            0,0,0,0,0,0,0,0,0,
            0,0,0,0,0,0,0,0,0,
            0,0,0,0,1,0,0,0,0,
            0,0,0,1,0,0,0,0,0,
            0,0,1,0,0,0,0,0,0,
            0,0,0,0,0,0,0,0,0,
            0,0,0,0,0,0,0,0,0,
            0,0,0,0,0,0,0,0,0
        ],
        "dropItems": [
            0,0,0,0,0,0,0,0,0,
            0,0,0,0,0,0,0,0,0,
            0,0,0,0,0,0,0,0,0,
            0,0,0,0,0,0,0,0,0,
            0,0,0,0,0,0,0,0,0,
            0,0,0,0,0,0,0,0,0,
            0,0,0,0,0,0,0,0,0,
            0,0,0,0,0,0,0,0,0,
            0,0,0,0,0,0,0,0,0
        ],
        "chains": [
            0,0,0,0,0,0,0,0,0,
            0,0,0,0,0,0,0,0,0,
            0,0,0,0,0,0,0,0,0,
            0,0,0,0,0,0,0,0,0,
            0,0,0,0,0,0,0,0,0,
            0,0,0,0,0,0,0,0,0,
            0,0,0,0,0,0,0,0,0,
            0,0,0,0,0,0,0,0,0,
            0,0,0,0,0,0,0,0,0
        ],
        "hiddenItems": [
            0,0,0,0,0,0,0,0,0,
            0,0,0,0,0,0,0,0,0,
            0,0,0,0,0,0,0,0,0,
            0,0,0,0,0,0,0,0,0,
            0,0,0,0,0,0,0,0,0,
            0,0,0,0,0,0,0,0,0,
            0,0,0,0,0,0,0,0,0,
            0,0,0,0,0,0,0,0,0,
            0,0,0,0,0,0,0,0,0
        ],
        "gemColors": [
            8,8,9,1,0,8,9,8,8,
            8,8,1,8,0,8,1,8,8,
            8,8,9,0,0,8,9,8,8,
            8,8,0,0,1,8,1,8,8,
            8,8,0,1,11,1,0,8,8,
            8,8,9,1,1,0,0,8,8,
            8,8,1,8,0,0,9,8,8,
            8,8,9,8,0,1,1,8,8,
            8,8,1,8,0,8,9,8,8
        ],
        "gemTypes": [
            0,0,0,7,0,2,0,0,0,
            0,0,7,0,0,0,7,0,0,
            0,0,1,0,0,2,0,0,0,
            0,0,0,0,7,0,0,0,0,
            0,0,0,10,0,10,0,0,0,
            0,0,0,7,8,0,0,0,0,
            0,0,7,0,0,0,1,0,0,
            0,0,0,1,0,0,7,0,0,
            0,0,0,0,0,1,0,0,0
        ],
        "gemModifier": [
            0,0,1,0,0,0,1,0,0,
            0,0,2,0,0,0,2,0,0,
            0,0,1,0,0,0,1,0,0,
            0,0,0,0,3,0,1,0,0,
            0,0,0,9,3,8,0,0,0,
            0,0,1,0,3,0,0,0,0,
            0,0,2,0,0,0,1,0,0,
            0,0,1,0,0,0,2,0,0,
            0,0,1,0,0,0,1,0,0
        ],
        "portals": [
            0,0,0,0,0,2,4,6,8,
            0,0,0,11,0,0,0,0,0,
            0,0,9,0,0,0,0,0,0,
            0,0,0,0,0,0,0,0,0,
            0,0,0,0,0,0,0,0,0,
            0,0,0,0,0,0,0,0,0,
            0,0,0,0,0,0,12,0,0,
            0,0,0,0,0,10,0,0,0,
            1,3,5,7,0,0,0,0,0
        ],
        "crates": [
            0,0,0,7,0,5,0,0,0,
            0,0,0,7,0,5,0,0,0,
            0,0,0,0,0,5,0,0,0,
            0,0,0,0,0,5,0,0,0,
            0,0,0,7,0,5,0,0,0,
            0,0,0,7,0,0,0,0,0,
            0,0,0,7,0,0,0,0,0,
            0,0,0,7,0,7,0,0,0,
            0,0,0,7,0,7,0,0,0
        ],
        "climbers": [
            0,0,0,0,0,0,0,0,0,
            0,0,0,0,0,0,0,0,0,
            0,0,0,0,0,0,0,0,0,
            0,0,0,0,0,0,0,0,0,
            0,0,0,0,0,0,0,0,0,
            0,0,0,0,0,0,0,0,0,
            0,0,0,0,0,0,0,0,0,
            0,0,0,0,0,0,0,0,0,
            0,0,0,0,0,0,0,0,0
        ]
    },
    "collectable": ""
}
