{
    "data": {
        "moves": 45,
        "gems": [
            {
                "type": "coins",
                "amount": 25
            },
            {
                "type": "yellow",
                "amount": 25
            },
            {
                "type": "purple",
                "amount": 25
            },
            {
                "type": "red",
                "amount": 25
            },
            {
                "type": "orange",
                "amount": 10
            }
        ],
        "objectives": [
            {
                "type": "climber",
                "amount": 3
            }
        ],
        "spawnRatioDroppable": {
            "gemColor": 0,
            "gemType": 0,
            "minSpawn": 0,
            "maxSpawn": 0,
            "probability": 0
        },
        "spawnRatios": [
            {
                "gemColor": 8,
                "gemType": 6,
                "minSpawn": 2,
                "maxSpawn": 5,
                "probability": 5
            }
        ],
        "hiddenItemName": "monkey"
    },
    "layout": {
        "fields": [
            0,0,1,0,0,1,0,0,1,
            0,1,1,0,1,1,0,1,1,
            1,1,1,1,1,1,1,1,1,
            1,1,1,1,1,1,1,1,1,
            1,1,1,1,1,1,1,1,1,
            1,1,1,1,1,1,1,1,1,
            1,1,1,1,1,1,1,1,1,
            1,1,1,1,1,1,1,1,1,
            1,1,1,1,1,1,1,1,1
        ],
        "tiles": [
            0,0,0,0,0,0,0,0,0,
            0,0,0,0,0,0,0,0,0,
            2,2,2,0,0,0,2,2,2,
            2,2,2,0,0,0,2,2,2,
            2,2,2,0,0,0,2,2,2,
            2,2,2,0,0,0,2,2,2,
            2,2,2,0,0,0,2,2,2,
            2,2,2,0,0,0,2,2,2,
            2,2,2,0,0,0,2,2,2
        ],
        "stones": [
            0,0,0,0,0,0,0,0,0,
            0,0,0,0,0,0,0,0,0,
            0,0,0,0,0,0,0,0,0,
            0,0,0,0,0,0,0,0,0,
            0,0,0,0,0,0,0,0,0,
            0,0,0,0,0,0,0,0,0,
            0,0,0,0,0,0,0,0,0,
            0,0,0,0,0,0,0,0,0,
            0,0,0,0,0,0,0,0,0
        ],
        "spawning": [
            0,0,1,0,0,1,0,0,1,
            0,1,0,0,1,0,0,1,0,
            1,0,0,1,0,0,1,0,0,
            0,0,0,0,0,0,0,0,0,
            0,0,0,0,0,0,0,0,0,
            0,0,0,0,0,0,0,0,0,
            0,0,0,0,0,0,0,0,0,
            0,0,0,0,0,0,0,0,0,
            0,0,0,0,0,0,0,0,0
        ],
        "dropItems": [
            0,0,0,0,0,0,0,0,0,
            0,0,0,0,0,0,0,0,0,
            0,0,0,0,0,0,0,0,0,
            0,0,0,0,0,0,0,0,0,
            0,0,0,0,0,0,0,0,0,
            0,0,0,0,0,0,0,0,0,
            0,0,0,0,0,0,0,0,0,
            0,0,0,0,0,0,0,0,0,
            0,0,0,0,0,0,0,0,0
        ],
        "chains": [
            0,0,0,0,0,0,0,0,0,
            0,0,0,0,0,0,0,0,0,
            0,0,0,0,0,0,0,0,0,
            0,0,0,0,0,0,0,0,0,
            0,0,0,0,0,0,0,0,0,
            0,0,0,0,0,0,0,0,0,
            0,0,0,0,0,0,0,0,0,
            0,0,0,0,0,0,0,0,0,
            0,0,0,0,0,0,0,0,0
        ],
        "hiddenItems": [
            0,0,0,0,0,0,0,0,0,
            0,0,0,0,0,0,0,0,0,
            1,1,1,0,0,0,2,2,2,
            1,1,1,0,0,0,2,2,2,
            1,1,1,0,0,0,2,2,2,
            0,0,0,0,0,0,0,0,0,
            5,5,5,0,0,0,0,0,0,
            5,5,5,0,0,0,0,6,6,
            5,5,5,0,0,0,0,6,6
        ],
        "gemColors": [
            0,0,8,0,0,8,0,0,8,
            0,8,8,0,8,8,0,8,8,
            8,8,4,5,8,8,8,8,8,
            8,8,4,8,8,8,8,8,8,
            8,8,8,5,8,4,5,8,8,
            8,8,4,5,8,8,8,8,8,
            8,8,8,8,8,4,5,8,8,
            8,8,8,8,8,4,5,8,8,
            5,8,12,8,8,8,8,8,5
        ],
        "gemTypes": [
            0,0,0,0,0,0,0,0,6,
            0,0,6,0,0,6,0,6,0,
            0,6,0,6,6,0,0,0,6,
            0,0,6,0,0,6,0,6,0,
            0,0,0,0,6,0,6,0,6,
            0,6,0,6,0,6,0,6,0,
            0,0,6,0,6,0,0,0,6,
            0,6,0,0,0,6,6,6,0,
            6,0,0,0,6,0,0,0,6
        ],
        "gemModifier": [
            0,0,0,0,0,0,0,0,0,
            0,0,0,0,0,0,0,0,0,
            0,0,0,0,0,0,0,0,0,
            0,0,0,0,0,0,0,0,0,
            0,0,0,0,0,0,0,0,0,
            0,0,0,0,0,0,0,0,0,
            0,0,0,0,0,0,0,0,0,
            0,0,0,0,0,0,0,0,0,
            0,0,0,0,0,0,0,0,0
        ],
        "portals": [
            0,0,0,0,0,0,0,0,0,
            0,0,0,0,0,0,0,0,0,
            0,0,0,0,0,0,0,0,0,
            0,0,0,0,0,0,0,0,0,
            0,0,0,0,0,0,0,0,0,
            0,0,0,0,0,0,0,0,0,
            0,0,0,0,0,0,0,0,0,
            0,0,0,0,0,0,0,0,0,
            0,0,0,0,0,0,0,0,0
        ],
        "crates": [
            0,0,21,0,0,21,0,0,21,
            0,18,21,0,18,21,0,18,21,
            0,18,21,0,18,21,0,18,21,
            0,18,21,0,18,21,0,18,21,
            0,18,21,0,18,21,0,18,21,
            0,18,21,0,18,21,0,18,21,
            0,18,21,0,18,21,0,18,21,
            0,18,21,0,18,21,0,18,21,
            0,18,0,0,18,0,0,18,0
        ],
        "climbers": [
            0,0,2,0,0,2,0,0,2,
            0,2,0,0,2,0,0,2,0,
            2,0,0,2,0,0,2,0,0,
            0,0,0,0,0,0,0,0,0,
            0,0,0,0,0,0,0,0,0,
            0,0,0,0,0,0,0,0,0,
            0,0,0,0,0,0,0,0,0,
            0,0,0,0,0,0,0,0,0,
            0,0,1,0,0,1,0,0,1
        ]
    },
    "collectable": ""
}
