{
    "data": {
        "moves": 32,
        "gems": [
            {
                "type": "coins",
                "amount": 25
            },
            {
                "type": "orange",
                "amount": 25
            },
            {
                "type": "purple",
                "amount": 25
            },
            {
                "type": "red",
                "amount": 25
            },
            {
                "type": "blue",
                "amount": 8
            }
        ],
        "objectives": [
            {
                "type": "droppable",
                "amount": 8
            }
        ],
        "spawnRatioDroppable": {
            "gemColor": 0,
            "gemType": 0,
            "minSpawn": 0,
            "maxSpawn": 0,
            "probability": 0
        },
        "spawnRatios": [
            
        ],
        "hiddenItemName": "monkey"
    },
    "layout": {
        "fields": [
            0,0,1,0,0,0,1,0,0,
            0,0,1,1,1,1,1,0,0,
            0,0,1,1,1,1,1,0,0,
            0,0,1,1,1,1,1,0,0,
            0,0,1,1,1,1,1,0,0,
            1,0,1,1,1,1,1,0,1,
            1,0,1,1,1,1,1,0,1,
            1,0,1,1,1,1,1,0,1,
            1,0,1,1,1,1,1,0,1
        ],
        "tiles": [
            0,0,0,0,0,0,0,0,0,
            0,0,2,2,2,2,2,0,0,
            0,0,2,2,2,2,2,0,0,
            0,0,2,2,2,2,2,0,0,
            0,0,1,1,1,1,1,0,0,
            0,0,1,1,1,1,1,0,0,
            0,0,1,1,1,1,1,0,0,
            0,0,1,1,1,1,1,0,0,
            0,0,1,1,1,1,1,0,0
        ],
        "stones": [
            0,0,0,0,0,0,0,0,0,
            0,0,0,0,0,0,0,0,0,
            0,0,0,0,0,0,0,0,0,
            0,0,0,0,0,0,0,0,0,
            0,0,0,0,0,0,0,0,0,
            0,0,0,0,0,0,0,0,0,
            0,0,0,0,0,0,0,0,0,
            0,0,0,0,0,0,0,0,0,
            0,0,0,0,0,0,0,0,0
        ],
        "spawning": [
            0,0,0,0,0,0,0,0,0,
            0,0,0,1,1,1,0,0,0,
            0,0,0,0,0,0,0,0,0,
            0,0,0,0,0,0,0,0,0,
            0,0,0,0,0,0,0,0,0,
            0,0,0,0,0,0,0,0,0,
            0,0,0,0,0,0,0,0,0,
            0,0,0,0,0,0,0,0,0,
            0,0,0,0,0,0,0,0,0
        ],
        "dropItems": [
            0,0,0,0,0,0,0,0,0,
            0,0,0,0,0,0,0,0,0,
            0,0,0,0,0,0,0,0,0,
            0,0,0,0,0,0,0,0,0,
            0,0,0,0,0,0,0,0,0,
            1,0,0,0,0,0,0,0,1,
            0,0,0,0,0,0,0,0,0,
            0,0,0,0,0,0,0,0,0,
            0,0,2,2,2,2,2,0,0
        ],
        "chains": [
            0,0,0,0,0,0,0,0,0,
            0,0,2,1,0,1,2,0,0,
            0,0,2,0,0,0,1,0,0,
            0,0,2,0,0,0,2,0,0,
            0,0,2,0,0,0,2,0,0,
            1,0,2,0,0,0,2,0,1,
            1,0,2,0,0,0,2,0,1,
            1,0,2,0,0,0,2,0,1,
            1,0,2,0,0,0,2,0,1
        ],
        "hiddenItems": [
            0,0,0,0,0,0,0,0,0,
            0,0,5,5,0,6,6,0,0,
            0,0,5,5,0,6,6,0,0,
            0,0,1,1,0,3,3,0,0,
            0,0,1,1,0,3,3,0,0,
            0,0,2,2,0,4,4,0,0,
            0,0,2,2,0,4,4,0,0,
            0,0,7,7,0,8,8,0,0,
            0,0,7,7,0,8,8,0,0
        ],
        "gemColors": [
            0,0,8,0,0,0,8,0,0,
            0,0,8,8,8,8,8,0,0,
            0,0,8,8,8,8,8,0,0,
            0,0,8,8,8,8,8,0,0,
            0,0,8,8,8,8,8,0,0,
            7,0,8,8,8,8,8,0,7,
            7,0,8,8,8,8,8,0,7,
            7,0,8,8,8,8,8,0,7,
            7,0,8,8,8,8,8,0,7
        ],
        "gemTypes": [
            0,0,0,0,0,0,0,0,0,
            0,0,0,0,0,0,0,0,0,
            0,0,0,0,0,0,0,0,0,
            0,0,0,0,0,0,0,0,0,
            0,0,0,0,0,0,0,0,0,
            0,0,0,0,0,0,0,0,0,
            0,0,0,0,0,0,0,0,0,
            0,0,0,0,0,0,0,0,0,
            0,0,0,0,0,0,0,0,0
        ],
        "gemModifier": [
            0,0,0,0,0,0,0,0,0,
            0,0,0,0,0,0,0,0,0,
            0,0,0,0,0,0,0,0,0,
            0,0,0,0,0,0,0,0,0,
            0,0,0,0,0,0,0,0,0,
            0,0,0,0,0,0,0,0,0,
            0,0,0,0,0,0,0,0,0,
            0,0,0,0,0,0,0,0,0,
            0,0,0,0,0,0,0,0,0
        ],
        "portals": [
            0,0,2,0,0,0,4,0,0,
            0,0,0,0,0,0,0,0,0,
            0,0,0,0,0,0,0,0,0,
            0,0,0,0,0,0,0,0,0,
            0,0,0,0,0,0,0,0,0,
            0,0,0,0,0,0,0,0,0,
            0,0,0,0,0,0,0,0,0,
            0,0,0,0,0,0,0,0,0,
            1,0,0,0,0,0,0,0,3
        ],
        "crates": [
            0,0,0,0,0,0,0,0,0,
            0,0,0,0,0,0,0,0,0,
            0,0,0,0,0,0,0,0,0,
            0,0,0,0,0,0,0,0,0,
            0,0,0,0,0,0,0,0,0,
            0,0,0,0,0,0,0,0,0,
            0,0,0,0,0,0,0,0,0,
            0,0,0,0,0,0,0,0,0,
            0,0,0,0,0,0,0,0,0
        ],
        "climbers": [
            0,0,0,0,0,0,0,0,0,
            0,0,0,0,0,0,0,0,0,
            0,0,0,0,0,0,0,0,0,
            0,0,0,0,0,0,0,0,0,
            0,0,0,0,0,0,0,0,0,
            0,0,0,0,0,0,0,0,0,
            0,0,0,0,0,0,0,0,0,
            0,0,0,0,0,0,0,0,0,
            0,0,0,0,0,0,0,0,0
        ]
    },
    "collectable": ""
}
