{
    "data": {
        "moves": 31,
        "gems": [
            {
                "type": "coins",
                "amount": 25
            },
            {
                "type": "red",
                "amount": 25
            },
            {
                "type": "purple",
                "amount": 25
            },
            {
                "type": "green",
                "amount": 21
            }
        ],
        "objectives": [
            
        ],
        "spawnRatioDroppable": {
            "gemColor": 0,
            "gemType": 0,
            "minSpawn": 0,
            "maxSpawn": 0,
            "probability": 0
        },
        "spawnRatios": [
            
        ],
        "hiddenItemName": "monkey"
    },
    "layout": {
        "fields": [
            1,1,0,0,0,0,0,0,0,
            1,1,1,0,0,0,0,0,0,
            1,1,1,0,1,1,1,1,0,
            1,1,1,0,1,1,1,1,1,
            1,1,1,1,1,1,1,1,1,
            1,1,1,0,1,1,1,1,1,
            1,1,1,0,1,1,1,1,0,
            1,1,1,0,0,0,0,0,0,
            1,1,0,0,0,0,0,0,0
        ],
        "tiles": [
            2,2,0,0,0,0,0,0,0,
            2,2,2,0,0,0,0,0,0,
            2,2,2,0,2,2,2,2,0,
            2,2,2,0,2,2,2,2,2,
            2,2,2,0,2,2,2,2,2,
            2,2,2,0,2,2,2,2,2,
            2,2,2,0,2,2,2,2,0,
            2,2,2,0,0,0,0,0,0,
            2,2,0,0,0,0,0,0,0
        ],
        "stones": [
            0,0,0,0,0,0,0,0,0,
            0,0,0,0,0,0,0,0,0,
            0,0,0,0,0,0,0,0,0,
            0,0,0,0,0,0,0,0,0,
            0,0,0,0,0,0,0,0,0,
            0,0,0,0,0,0,0,0,0,
            0,0,0,0,0,0,0,0,0,
            0,0,0,0,0,0,0,0,0,
            0,0,0,0,0,0,0,0,0
        ],
        "spawning": [
            1,1,0,0,0,0,0,0,0,
            0,0,1,0,0,0,0,0,0,
            0,0,0,0,1,1,1,1,0,
            0,0,0,0,0,0,0,0,1,
            0,0,0,0,0,0,0,0,0,
            0,0,0,0,0,0,0,0,0,
            0,0,0,0,0,0,0,0,0,
            0,0,0,0,0,0,0,0,0,
            0,0,0,0,0,0,0,0,0
        ],
        "dropItems": [
            0,0,0,0,0,0,0,0,0,
            0,0,0,0,0,0,0,0,0,
            0,0,0,0,0,0,0,0,0,
            0,0,0,0,0,0,0,0,0,
            0,0,0,0,0,0,0,0,0,
            0,0,0,0,0,0,0,0,0,
            0,0,0,0,0,0,0,0,0,
            0,0,0,0,0,0,0,0,0,
            0,0,0,0,0,0,0,0,0
        ],
        "chains": [
            0,0,0,0,0,0,0,0,0,
            0,0,0,0,0,0,0,0,0,
            0,0,0,0,0,0,0,0,0,
            0,0,0,0,0,0,0,0,0,
            0,0,0,0,0,0,0,0,0,
            0,0,0,0,0,0,0,0,0,
            0,0,0,0,0,0,0,0,0,
            0,0,0,0,0,0,0,0,0,
            0,0,0,0,0,0,0,0,0
        ],
        "hiddenItems": [
            8,8,0,0,0,0,0,0,0,
            8,8,0,0,0,0,0,0,0,
            0,2,2,0,5,5,0,0,0,
            0,2,2,0,5,5,1,1,1,
            0,0,0,0,0,0,1,1,1,
            0,3,3,0,6,6,1,1,1,
            0,3,3,0,6,6,0,0,0,
            7,7,0,0,0,0,0,0,0,
            7,7,0,0,0,0,0,0,0
        ],
        "gemColors": [
            8,8,0,0,0,0,0,0,0,
            8,8,8,0,0,0,0,0,0,
            8,8,9,0,8,8,8,8,0,
            8,8,1,0,8,8,8,8,8,
            8,8,8,8,8,8,8,8,8,
            8,8,5,0,8,8,8,8,8,
            8,8,2,0,8,8,8,8,0,
            8,8,8,0,0,0,0,0,0,
            8,8,0,0,0,0,0,0,0
        ],
        "gemTypes": [
            0,0,0,0,0,0,0,0,0,
            0,0,0,0,0,0,0,0,0,
            0,0,10,0,0,0,0,0,0,
            0,0,10,0,0,0,0,0,0,
            0,0,0,0,0,0,0,0,0,
            0,0,10,0,0,0,0,0,0,
            0,0,10,0,0,0,0,0,0,
            0,0,0,0,0,0,0,0,0,
            0,0,0,0,0,0,0,0,0
        ],
        "gemModifier": [
            0,0,0,0,0,0,0,0,0,
            0,0,0,0,0,0,0,0,0,
            0,0,9,0,0,0,0,0,0,
            0,0,8,0,0,0,0,0,0,
            0,0,0,0,0,0,0,0,0,
            0,0,8,0,0,0,0,0,0,
            0,0,9,0,0,0,0,0,0,
            0,0,0,0,0,0,0,0,0,
            0,0,0,0,0,0,0,0,0
        ],
        "portals": [
            0,0,0,0,0,0,0,0,0,
            0,0,0,0,0,0,0,0,0,
            0,0,0,0,0,0,0,0,0,
            0,0,0,0,0,0,0,0,0,
            0,0,0,0,0,0,0,0,0,
            0,0,0,0,0,0,0,0,0,
            0,0,0,0,0,0,0,0,0,
            0,0,0,0,0,0,0,0,0,
            0,0,0,0,0,0,0,0,0
        ],
        "crates": [
            0,0,0,0,0,0,0,0,0,
            0,0,10,0,0,0,0,0,0,
            0,0,38,0,3,3,3,3,0,
            0,0,7,0,1,2,2,1,1,
            0,0,22,2,2,2,2,2,2,
            0,0,23,0,1,2,2,1,1,
            0,0,10,0,3,3,3,3,0,
            0,0,38,0,0,0,0,0,0,
            0,0,0,0,0,0,0,0,0
        ],
        "climbers": [
            0,0,0,0,0,0,0,0,0,
            0,0,0,0,0,0,0,0,0,
            0,0,0,0,0,0,0,0,0,
            0,0,0,0,0,0,0,0,0,
            0,0,0,0,0,0,0,0,0,
            0,0,0,0,0,0,0,0,0,
            0,0,0,0,0,0,0,0,0,
            0,0,0,0,0,0,0,0,0,
            0,0,0,0,0,0,0,0,0
        ]
    },
    "collectable": ""
}
