{
    "data": {
        "moves": 40,
        "gems": [
            {
                "type": "coins",
                "amount": 25
            },
            {
                "type": "yellow",
                "amount": 25
            },
            {
                "type": "red",
                "amount": 25
            },
            {
                "type": "green",
                "amount": 23
            }
        ],
        "objectives": [
            {
                "type": "climber",
                "amount": 3
            },
            {
                "type": "blue",
                "amount": 40
            }
        ],
        "spawnRatioDroppable": {
            "gemColor": 0,
            "gemType": 0,
            "minSpawn": 0,
            "maxSpawn": 0,
            "probability": 0
        },
        "spawnRatios": [
            {
                "gemColor": 8,
                "gemType": 6,
                "minSpawn": 2,
                "maxSpawn": 8,
                "probability": 6
            },
            {
                "gemColor": 3,
                "gemType": 8,
                "minSpawn": 0,
                "maxSpawn": 2,
                "probability": 3
            }
        ],
        "hiddenItemName": "monkey"
    },
    "layout": {
        "fields": [
            0,0,1,1,0,0,0,1,1,
            0,1,1,1,0,0,1,2,2,
            1,1,1,1,0,1,2,2,1,
            1,1,1,1,1,2,2,1,1,
            1,1,1,1,2,2,1,1,1,
            1,1,1,1,2,1,1,1,1,
            1,2,1,2,1,1,1,1,1,
            2,1,2,1,0,1,1,1,1,
            1,1,1,1,0,0,1,1,0
        ],
        "tiles": [
            0,0,0,0,0,0,0,0,0,
            0,0,0,0,0,0,0,0,0,
            0,0,0,0,0,0,0,0,0,
            0,0,0,0,0,0,0,0,0,
            0,0,0,0,0,0,0,0,0,
            0,0,0,0,0,0,0,0,0,
            0,0,0,0,0,0,0,0,0,
            0,0,0,0,0,0,0,0,0,
            0,0,0,0,0,0,0,0,0
        ],
        "stones": [
            0,0,0,0,0,0,0,0,0,
            0,0,0,0,0,0,0,0,0,
            0,0,0,0,0,0,0,0,0,
            0,0,0,0,3,0,0,0,3,
            0,0,0,0,0,0,0,3,3,
            0,0,0,0,0,0,3,3,0,
            0,0,0,0,0,3,3,0,3,
            0,0,0,0,0,3,0,3,3,
            0,1,1,1,0,0,3,3,0
        ],
        "spawning": [
            0,0,0,1,0,0,0,1,1,
            0,0,0,0,0,0,1,0,0,
            0,0,0,0,0,1,0,0,0,
            0,0,0,0,1,0,0,0,0,
            0,0,0,0,0,0,0,0,0,
            0,0,0,0,0,0,0,0,0,
            0,0,0,0,0,0,0,0,0,
            0,0,0,0,0,0,0,0,0,
            0,0,0,0,0,0,0,0,0
        ],
        "dropItems": [
            0,0,0,0,0,0,0,0,0,
            0,0,0,0,0,0,0,0,0,
            0,0,0,0,0,0,0,0,0,
            0,0,0,0,0,0,0,0,0,
            0,0,0,0,0,0,0,0,0,
            0,0,0,0,0,0,0,0,0,
            0,0,0,0,0,0,0,0,0,
            0,0,0,0,0,0,0,0,0,
            0,0,0,0,0,0,0,0,0
        ],
        "chains": [
            0,0,1,0,0,0,0,0,0,
            0,0,1,0,0,0,0,0,0,
            1,0,1,0,0,0,0,0,3,
            1,0,1,0,0,0,0,3,0,
            1,0,1,0,0,0,3,0,0,
            2,0,2,0,0,2,0,0,1,
            2,0,2,0,2,0,0,1,0,
            0,2,0,2,0,0,1,0,0,
            0,0,0,0,0,0,0,0,0
        ],
        "hiddenItems": [
            0,0,0,0,0,0,0,0,0,
            0,0,0,0,0,0,0,0,0,
            0,0,0,0,0,0,0,0,0,
            0,0,0,0,0,0,0,0,0,
            0,0,0,0,0,0,0,0,0,
            0,0,0,0,0,0,0,0,0,
            0,0,0,0,0,0,0,0,0,
            0,0,0,0,0,0,0,0,0,
            0,0,0,0,0,0,0,0,0
        ],
        "gemColors": [
            0,0,8,8,0,0,0,8,8,
            0,8,8,8,0,0,8,0,0,
            8,8,8,8,0,8,0,0,3,
            8,8,8,8,0,0,0,3,0,
            8,8,8,8,0,0,3,0,0,
            8,8,8,8,0,3,0,0,9,
            11,0,11,0,3,0,0,9,0,
            0,3,0,3,0,0,9,0,0,
            12,0,0,0,0,0,0,0,0
        ],
        "gemTypes": [
            0,0,6,0,0,0,0,0,0,
            0,0,6,0,0,0,0,0,0,
            6,0,6,0,0,0,0,0,8,
            6,0,6,0,0,0,0,8,0,
            6,0,6,0,0,0,8,0,0,
            6,0,6,0,0,8,0,0,6,
            0,0,0,0,8,0,0,6,0,
            0,0,0,0,0,0,6,0,0,
            0,0,0,0,0,0,0,0,0
        ],
        "gemModifier": [
            0,0,0,0,0,0,0,0,0,
            0,0,0,0,0,0,0,0,0,
            0,0,0,0,0,0,0,0,0,
            0,0,0,0,0,0,0,0,0,
            0,0,0,0,0,0,0,0,0,
            0,0,0,0,0,0,0,0,0,
            0,0,0,0,0,0,0,0,0,
            0,0,0,0,0,0,0,0,0,
            0,0,0,0,0,0,0,0,0
        ],
        "portals": [
            0,0,2,0,0,0,0,0,0,
            0,4,0,0,0,0,0,0,0,
            6,0,0,0,0,0,0,0,0,
            0,0,0,0,0,0,0,0,0,
            0,0,0,0,0,0,0,0,0,
            0,0,0,0,0,0,0,0,0,
            0,0,0,0,0,0,0,0,0,
            0,0,0,0,0,0,0,0,1,
            0,0,0,0,0,0,5,3,0
        ],
        "crates": [
            0,0,0,0,0,0,0,0,0,
            0,0,0,0,0,0,0,0,0,
            0,0,0,0,0,0,0,0,0,
            0,0,0,0,0,0,0,0,0,
            0,0,0,0,0,0,0,0,0,
            0,0,0,0,0,0,0,0,0,
            0,0,0,0,0,0,0,0,0,
            0,0,0,0,0,0,0,0,0,
            0,0,0,0,0,0,0,0,0
        ],
        "climbers": [
            0,0,0,2,0,0,0,2,2,
            0,0,0,0,0,0,2,0,0,
            0,0,0,0,0,2,0,0,0,
            0,0,0,0,2,0,0,0,0,
            0,0,0,0,0,0,0,0,0,
            0,0,0,0,0,0,0,0,0,
            0,0,0,0,0,0,0,0,0,
            0,0,0,0,0,0,0,0,0,
            0,1,1,0,0,0,0,0,0
        ]
    },
    "collectable": ""
}
