{
    "data": {
        "moves": 35,
        "gems": [
            {
                "type": "coins",
                "amount": 25
            },
            {
                "type": "yellow",
                "amount": 25
            },
            {
                "type": "purple",
                "amount": 25
            },
            {
                "type": "red",
                "amount": 25
            },
            {
                "type": "orange",
                "amount": 21
            }
        ],
        "objectives": [
            
        ],
        "spawnRatioDroppable": {
            "gemColor": 0,
            "gemType": 0,
            "minSpawn": 0,
            "maxSpawn": 0,
            "probability": 0
        },
        "spawnRatios": [
            
        ],
        "hiddenItemName": "monkey"
    },
    "layout": {
        "fields": [
            1,1,1,1,1,1,1,1,1,
            1,1,1,1,1,1,1,1,1,
            1,1,1,1,1,1,1,1,1,
            1,1,1,1,1,1,1,1,1,
            1,1,1,1,1,1,1,1,1,
            1,1,1,1,1,1,1,1,1,
            1,1,1,1,1,1,1,1,1,
            1,1,1,1,1,1,1,1,1,
            1,1,1,1,1,1,1,1,1
        ],
        "tiles": [
            2,2,2,2,2,2,2,2,0,
            2,2,2,2,2,2,2,2,0,
            2,2,2,2,2,2,2,2,0,
            2,2,2,2,2,2,2,2,0,
            2,2,2,2,2,2,2,0,0,
            2,2,2,2,2,2,0,0,0,
            2,2,2,2,2,0,0,0,0,
            2,2,2,2,0,0,0,1,1,
            2,2,2,0,0,0,0,1,1
        ],
        "stones": [
            0,0,0,0,0,0,0,0,0,
            0,0,0,0,0,0,0,0,0,
            0,0,0,0,0,0,0,0,0,
            0,0,0,0,11,12,0,0,0,
            0,0,0,0,12,12,0,0,0,
            0,0,11,12,0,0,0,0,0,
            0,0,12,12,0,0,0,0,0,
            0,0,0,0,0,0,0,0,0,
            0,0,0,0,0,0,0,0,0
        ],
        "spawning": [
            1,1,1,1,1,1,1,1,1,
            0,0,0,0,0,0,0,0,0,
            0,0,0,0,0,0,0,0,0,
            0,0,0,0,0,0,0,0,0,
            0,0,0,0,0,0,0,0,0,
            0,0,0,0,0,0,0,0,0,
            0,0,0,0,0,0,0,0,0,
            0,0,0,0,0,0,0,0,0,
            0,0,0,0,0,0,0,0,0
        ],
        "dropItems": [
            0,0,0,0,0,0,0,0,0,
            0,0,0,0,0,0,0,0,0,
            0,0,0,0,0,0,0,0,0,
            0,0,0,0,0,0,0,0,0,
            0,0,0,0,0,0,0,0,0,
            0,0,0,0,0,0,0,0,0,
            0,0,0,0,0,0,0,0,0,
            0,0,0,0,0,0,0,0,0,
            0,0,0,0,0,0,0,0,0
        ],
        "chains": [
            0,3,0,3,0,3,0,2,0,
            3,0,3,0,3,0,2,1,0,
            0,3,0,3,0,2,1,1,0,
            3,0,3,0,0,0,1,1,0,
            0,3,0,2,0,0,1,0,0,
            3,0,0,0,1,1,0,0,0,
            0,2,0,0,1,0,0,0,0,
            2,1,1,1,0,0,0,0,0,
            1,1,1,0,0,0,0,0,0
        ],
        "hiddenItems": [
            1,1,1,1,5,5,5,0,0,
            1,1,1,1,5,5,5,0,0,
            1,1,1,1,5,5,5,0,0,
            1,1,1,1,0,8,8,0,0,
            0,0,0,0,0,8,8,0,0,
            0,0,0,6,6,0,0,0,0,
            7,7,0,6,6,0,0,0,0,
            7,7,0,0,0,0,0,2,2,
            0,0,0,0,0,0,0,2,2
        ],
        "gemColors": [
            13,8,14,8,13,8,13,8,8,
            8,13,8,13,8,13,8,8,8,
            13,8,13,8,13,8,8,8,8,
            8,14,8,13,0,0,8,8,8,
            13,8,13,8,0,0,8,8,8,
            8,14,0,0,8,8,8,8,8,
            13,8,0,0,8,8,8,8,8,
            8,8,8,8,8,8,8,8,8,
            8,8,8,8,8,8,8,8,8
        ],
        "gemTypes": [
            0,0,0,0,0,0,0,0,0,
            0,0,0,0,0,0,0,0,0,
            0,0,0,0,0,0,0,0,0,
            0,0,0,0,0,0,0,0,0,
            0,0,0,0,0,0,0,0,0,
            0,0,0,0,0,0,0,0,0,
            0,0,0,0,0,0,0,0,0,
            0,0,0,0,0,0,0,0,0,
            0,0,0,0,0,0,0,0,0
        ],
        "gemModifier": [
            6,0,6,0,6,0,6,0,0,
            0,6,0,6,0,5,0,0,0,
            6,0,6,0,6,0,0,0,0,
            0,6,0,5,0,0,0,0,0,
            6,0,6,0,0,0,0,0,0,
            0,5,0,0,0,0,0,0,0,
            6,0,0,0,0,0,0,0,0,
            0,0,0,0,0,0,0,0,0,
            0,0,0,0,0,0,0,0,0
        ],
        "portals": [
            0,0,0,0,0,0,0,0,0,
            0,0,0,0,0,0,0,0,0,
            0,0,0,0,0,0,0,0,0,
            0,0,0,0,0,0,0,0,0,
            0,0,0,0,0,0,0,0,0,
            0,0,0,0,0,0,0,0,0,
            0,0,0,0,0,0,0,0,0,
            0,0,0,0,0,0,0,0,0,
            0,0,0,0,0,0,0,0,0
        ],
        "crates": [
            0,0,0,0,0,0,0,0,0,
            0,0,0,0,0,0,0,0,0,
            0,0,0,0,0,0,0,0,0,
            0,0,0,0,0,0,0,0,0,
            0,0,0,0,0,0,0,0,0,
            0,0,0,0,0,0,0,0,0,
            0,0,0,0,0,0,0,0,0,
            0,0,0,0,0,0,0,0,0,
            0,0,0,0,0,0,0,0,0
        ],
        "climbers": [
            0,0,0,0,0,0,0,0,0,
            0,0,0,0,0,0,0,0,0,
            0,0,0,0,0,0,0,0,0,
            0,0,0,0,0,0,0,0,0,
            0,0,0,0,0,0,0,0,0,
            0,0,0,0,0,0,0,0,0,
            0,0,0,0,0,0,0,0,0,
            0,0,0,0,0,0,0,0,0,
            0,0,0,0,0,0,0,0,0
        ]
    },
    "collectable": ""
}
