{
    "data": {
        "moves": 31,
        "gems": [
            {
                "type": "coins",
                "amount": 25
            },
            {
                "type": "red",
                "amount": 25
            },
            {
                "type": "purple",
                "amount": 25
            },
            {
                "type": "green",
                "amount": 25
            },
            {
                "type": "blue",
                "amount": 25
            }
        ],
        "objectives": [
            {
                "type": "coins",
                "amount": 160
            }
        ],
        "spawnRatioDroppable": {
            "gemColor": 0,
            "gemType": 0,
            "minSpawn": 0,
            "maxSpawn": 0,
            "probability": 0
        },
        "spawnRatios": [
            {
                "gemColor": 9,
                "gemType": 7,
                "minSpawn": 1,
                "maxSpawn": 3,
                "probability": 5
            }
        ],
        "hiddenItemName": "monkey"
    },
    "layout": {
        "fields": [
            0,1,1,1,0,1,1,1,0,
            1,1,1,1,1,1,1,1,1,
            1,1,1,1,0,1,1,1,1,
            1,1,1,0,0,1,1,1,1,
            1,1,1,1,1,0,0,1,0,
            1,1,1,1,1,0,1,1,1,
            1,1,1,1,1,1,1,1,1,
            1,1,1,1,1,1,1,1,1,
            1,1,1,1,1,1,1,1,0
        ],
        "tiles": [
            0,2,2,2,0,2,2,2,0,
            2,2,2,2,0,2,2,2,2,
            2,2,2,2,0,2,2,2,2,
            2,2,2,0,0,2,2,2,2,
            0,0,2,2,2,0,0,0,0,
            0,2,2,2,2,0,2,2,2,
            2,2,2,2,2,2,2,2,2,
            2,2,2,2,0,2,2,2,2,
            2,2,2,0,0,2,2,2,0
        ],
        "stones": [
            0,0,0,0,0,0,0,0,0,
            0,0,0,0,0,0,0,0,0,
            0,0,0,0,0,0,0,0,0,
            0,0,0,0,0,0,0,0,0,
            0,0,0,0,0,0,0,0,0,
            0,0,0,0,0,0,0,0,0,
            0,0,0,0,0,0,0,0,0,
            0,0,0,0,0,0,0,0,0,
            0,0,0,0,0,0,0,0,0
        ],
        "spawning": [
            0,1,1,1,0,1,1,1,0,
            1,0,0,0,1,0,0,0,1,
            0,0,0,0,0,0,0,0,0,
            0,0,0,0,0,0,0,0,0,
            0,0,0,1,1,0,0,0,0,
            0,0,0,0,0,0,1,0,1,
            0,0,0,0,0,1,0,0,0,
            0,0,0,0,0,0,0,0,0,
            0,0,0,0,0,0,0,0,0
        ],
        "dropItems": [
            0,0,0,0,0,0,0,0,0,
            0,0,0,0,0,0,0,0,0,
            0,0,0,0,0,0,0,0,0,
            0,0,0,0,0,0,0,0,0,
            0,0,0,0,0,0,0,0,0,
            0,0,0,0,0,0,0,0,0,
            0,0,0,0,0,0,0,0,0,
            0,0,0,0,0,0,0,0,0,
            0,0,0,0,0,0,0,0,0
        ],
        "chains": [
            0,0,0,0,0,0,0,0,0,
            0,0,0,0,0,0,0,0,0,
            0,0,0,0,0,0,0,0,0,
            0,0,0,0,0,0,0,0,0,
            0,0,0,0,0,0,0,0,0,
            0,0,0,0,0,0,0,0,0,
            0,0,0,0,0,0,0,0,0,
            0,0,0,0,0,0,0,0,0,
            0,0,0,0,0,0,0,0,0
        ],
        "hiddenItems": [
            0,7,7,7,0,0,0,0,0,
            0,7,7,7,0,0,5,5,5,
            0,7,7,7,0,0,5,5,5,
            0,0,0,0,0,0,5,5,5,
            0,0,0,0,0,0,0,0,0,
            0,8,8,8,0,0,6,6,6,
            0,8,8,8,0,0,6,6,6,
            0,8,8,8,0,0,6,6,6,
            0,0,0,0,0,0,0,0,0
        ],
        "gemColors": [
            0,8,8,8,0,9,9,9,0,
            8,8,8,8,9,0,9,0,9,
            8,8,8,8,0,9,0,9,9,
            8,8,8,0,0,0,9,0,9,
            9,8,9,8,9,0,0,9,0,
            8,9,8,9,8,0,8,8,8,
            9,8,9,8,9,8,8,8,8,
            8,9,8,9,8,8,8,8,8,
            9,8,9,8,9,8,8,8,0
        ],
        "gemTypes": [
            0,0,0,0,0,7,7,7,0,
            0,0,0,0,10,0,7,0,7,
            0,0,0,0,0,7,0,7,7,
            0,0,0,0,0,0,7,0,7,
            10,0,0,0,0,0,0,10,0,
            0,0,0,7,0,0,0,0,0,
            0,0,7,0,0,0,0,0,0,
            0,7,0,7,0,0,0,0,0,
            0,0,0,0,10,0,0,0,0
        ],
        "gemModifier": [
            0,0,0,0,0,0,0,0,0,
            0,0,0,0,7,0,0,0,0,
            0,0,0,0,0,0,0,0,0,
            0,0,0,0,0,0,0,0,0,
            7,0,0,0,0,0,0,8,0,
            0,0,0,0,0,0,0,0,0,
            0,0,0,0,0,0,0,0,0,
            0,0,0,0,0,0,0,0,0,
            0,0,0,0,7,0,0,0,0
        ],
        "portals": [
            0,0,0,0,0,0,0,0,0,
            0,0,0,0,0,0,0,0,0,
            0,0,0,0,0,0,0,0,0,
            0,0,0,0,0,0,0,0,0,
            0,0,0,0,0,0,0,0,0,
            0,0,0,0,0,0,0,0,0,
            0,0,0,0,0,0,0,0,0,
            0,0,0,0,0,0,0,0,0,
            0,0,0,0,0,0,0,0,0
        ],
        "crates": [
            0,0,0,0,0,2,2,2,0,
            0,0,0,0,3,0,2,0,2,
            0,0,0,0,0,2,0,2,2,
            0,0,0,0,0,0,2,0,2,
            0,0,1,2,1,0,0,3,0,
            0,1,2,1,2,0,0,0,0,
            1,2,1,2,1,0,0,0,0,
            2,1,2,1,0,0,0,0,0,
            1,2,1,0,0,0,0,0,0
        ],
        "climbers": [
            0,0,0,0,0,0,0,0,0,
            0,0,0,0,0,0,0,0,0,
            0,0,0,0,0,0,0,0,0,
            0,0,0,0,0,0,0,0,0,
            0,0,0,0,0,0,0,0,0,
            0,0,0,0,0,0,0,0,0,
            0,0,0,0,0,0,0,0,0,
            0,0,0,0,0,0,0,0,0,
            0,0,0,0,0,0,0,0,0
        ]
    },
    "collectable": ""
}
