{
    "data": {
        "moves": 30,
        "gems": [
            {
                "type": "coins",
                "amount": 25
            },
            {
                "type": "red",
                "amount": 25
            },
            {
                "type": "blue",
                "amount": 25
            },
            {
                "type": "green",
                "amount": 25
            },
            {
                "type": "orange",
                "amount": 3
            }
        ],
        "objectives": [
            {
                "type": "blue",
                "amount": 90
            }
        ],
        "spawnRatioDroppable": {
            "gemColor": 0,
            "gemType": 0,
            "minSpawn": 0,
            "maxSpawn": 0,
            "probability": 0
        },
        "spawnRatios": [
            
        ],
        "hiddenItemName": "monkey"
    },
    "layout": {
        "fields": [
            1,1,1,1,1,1,1,1,1,
            1,1,1,1,1,1,1,1,1,
            1,1,1,1,1,1,1,1,1,
            1,1,1,0,0,0,1,1,1,
            1,1,1,0,1,0,1,1,1,
            1,1,1,0,0,0,1,1,1,
            1,1,1,1,1,1,1,1,1,
            1,1,1,1,1,1,1,1,1,
            1,1,1,1,1,1,1,1,1
        ],
        "tiles": [
            0,0,0,0,0,0,0,0,0,
            0,0,0,0,0,0,0,0,0,
            0,0,0,0,0,0,0,0,0,
            0,0,0,0,0,0,0,0,0,
            0,0,0,0,0,0,0,0,0,
            0,0,0,0,0,0,0,0,0,
            0,0,0,0,0,0,0,0,0,
            0,0,0,0,0,0,0,0,0,
            0,0,0,0,0,0,0,0,0
        ],
        "stones": [
            0,0,0,0,4,0,0,0,0,
            0,0,0,0,4,0,0,0,0,
            0,0,0,0,4,0,0,0,0,
            0,0,0,0,0,0,0,0,0,
            4,4,4,0,0,0,4,4,4,
            0,0,2,0,0,0,2,0,0,
            0,0,2,0,4,0,2,0,0,
            0,2,0,0,4,0,0,2,0,
            2,0,0,0,4,0,0,0,2
        ],
        "spawning": [
            1,1,1,1,1,1,1,1,1,
            0,0,0,0,0,0,0,0,0,
            0,0,0,0,0,0,0,0,0,
            0,0,0,0,0,0,0,0,0,
            0,0,0,0,1,0,0,0,0,
            0,0,0,0,0,0,0,0,0,
            0,0,0,1,1,1,0,0,0,
            0,0,0,0,0,0,0,0,0,
            0,0,0,0,0,0,0,0,0
        ],
        "dropItems": [
            0,0,0,0,0,0,0,0,0,
            0,0,0,0,0,0,0,0,0,
            0,0,0,0,0,0,0,0,0,
            0,0,0,0,0,0,0,0,0,
            0,0,0,0,0,0,0,0,0,
            0,0,0,0,0,0,0,0,0,
            0,0,0,0,0,0,0,0,0,
            0,0,0,0,0,0,0,0,0,
            0,0,0,0,0,0,0,0,0
        ],
        "chains": [
            0,0,0,0,0,0,0,0,0,
            0,0,0,0,0,0,0,0,0,
            0,0,0,0,0,0,0,0,0,
            0,0,0,0,0,0,0,0,0,
            0,0,0,0,0,0,0,0,0,
            0,0,0,0,0,0,0,0,0,
            0,0,0,0,0,0,0,0,0,
            0,0,0,0,0,0,0,0,0,
            0,0,0,0,0,0,0,0,0
        ],
        "hiddenItems": [
            0,0,0,0,0,0,0,0,0,
            0,0,0,0,0,0,0,0,0,
            0,0,0,0,0,0,0,0,0,
            0,0,0,0,0,0,0,0,0,
            0,0,0,0,0,0,0,0,0,
            0,0,0,0,0,0,0,0,0,
            0,0,0,0,0,0,0,0,0,
            0,0,0,0,0,0,0,0,0,
            0,0,0,0,0,0,0,0,0
        ],
        "gemColors": [
            8,8,8,8,0,8,8,8,8,
            8,8,8,8,0,8,8,8,8,
            8,8,8,8,0,8,8,8,8,
            8,8,8,0,0,0,8,8,8,
            0,0,0,0,2,0,0,0,0,
            8,8,0,0,0,0,0,8,8,
            8,11,0,13,0,13,0,8,11,
            8,0,13,14,0,14,13,0,8,
            0,13,14,13,0,13,14,13,0
        ],
        "gemTypes": [
            0,0,0,0,0,0,0,0,0,
            0,0,0,0,0,0,0,0,0,
            0,0,0,0,0,0,0,0,0,
            0,0,0,0,0,0,0,0,0,
            0,0,0,0,10,0,0,0,0,
            2,0,0,0,0,0,0,1,0,
            1,0,0,0,0,0,0,0,0,
            0,0,0,0,0,0,0,0,2,
            0,0,0,0,0,0,0,0,0
        ],
        "gemModifier": [
            0,0,0,0,0,0,0,0,0,
            0,0,0,0,0,0,0,0,0,
            0,0,0,0,0,0,0,0,0,
            0,0,0,0,0,0,0,0,0,
            0,0,0,0,7,0,0,0,0,
            0,0,0,0,0,0,0,0,0,
            0,0,0,5,0,5,0,0,0,
            0,0,5,5,0,5,5,0,0,
            0,5,5,5,0,5,5,5,0
        ],
        "portals": [
            0,0,0,0,0,0,0,0,0,
            0,0,0,0,0,0,0,0,0,
            0,0,0,0,0,0,0,0,0,
            0,0,0,0,0,0,0,0,0,
            0,0,0,0,0,0,0,0,0,
            0,0,0,0,0,0,0,0,0,
            0,0,0,0,0,0,0,0,0,
            0,0,0,0,0,0,0,0,0,
            0,0,0,0,0,0,0,0,0
        ],
        "crates": [
            0,0,0,0,0,0,0,0,0,
            0,0,0,0,0,0,0,0,0,
            0,0,0,0,0,0,0,0,0,
            0,0,0,0,0,0,0,0,0,
            0,0,0,0,0,0,0,0,0,
            10,10,0,0,0,0,0,10,10,
            10,10,0,0,0,0,0,10,10,
            10,0,0,0,0,0,0,0,10,
            0,0,0,0,0,0,0,0,0
        ],
        "climbers": [
            0,0,0,0,0,0,0,0,0,
            0,0,0,0,0,0,0,0,0,
            0,0,0,0,0,0,0,0,0,
            0,0,0,0,0,0,0,0,0,
            0,0,0,0,0,0,0,0,0,
            0,0,0,0,0,0,0,0,0,
            0,0,0,0,0,0,0,0,0,
            0,0,0,0,0,0,0,0,0,
            0,0,0,0,0,0,0,0,0
        ]
    },
    "collectable": ""
}
