{
    "data": {
        "moves": 30,
        "gems": [
            {
                "type": "coins",
                "amount": 25
            },
            {
                "type": "red",
                "amount": 25
            },
            {
                "type": "orange",
                "amount": 25
            },
            {
                "type": "green",
                "amount": 25
            },
            {
                "type": "yellow",
                "amount": 5
            }
        ],
        "objectives": [
            
        ],
        "spawnRatioDroppable": {
            "gemColor": 0,
            "gemType": 0,
            "minSpawn": 0,
            "maxSpawn": 0,
            "probability": 0
        },
        "spawnRatios": [
            
        ],
        "hiddenItemName": "monkey"
    },
    "layout": {
        "fields": [
            1,1,1,1,0,3,3,3,3,
            1,1,1,1,0,1,3,1,3,
            1,1,1,1,0,3,3,3,3,
            0,1,1,1,0,1,3,1,3,
            0,3,1,3,0,1,1,3,1,
            0,1,3,1,0,1,3,1,3,
            1,3,1,3,1,3,3,3,3,
            0,1,3,1,3,1,3,1,3,
            1,3,1,3,1,3,3,3,3
        ],
        "tiles": [
            0,0,0,0,0,2,2,2,2,
            0,0,0,0,0,2,2,2,2,
            0,0,0,0,0,2,2,2,2,
            0,2,2,2,0,0,2,2,2,
            0,2,2,2,0,0,2,2,2,
            0,2,2,2,0,0,2,2,2,
            0,2,2,2,2,2,2,2,2,
            0,2,2,2,2,2,2,2,2,
            0,2,2,2,2,2,2,2,2
        ],
        "stones": [
            0,0,0,0,0,0,0,0,0,
            0,0,0,0,0,0,0,0,0,
            0,0,0,0,0,0,0,0,0,
            0,0,0,0,0,0,0,0,0,
            0,0,0,0,0,0,0,0,0,
            0,0,0,0,0,0,0,0,0,
            0,0,0,0,0,0,0,0,0,
            0,0,0,0,0,0,0,0,0,
            0,0,0,0,0,0,0,0,0
        ],
        "spawning": [
            1,1,1,1,0,1,1,1,1,
            0,0,0,0,0,0,0,0,0,
            0,0,0,0,0,0,0,0,0,
            0,0,0,0,0,2,0,0,0,
            0,0,0,0,0,2,0,0,0,
            0,0,0,0,0,2,0,0,0,
            2,0,0,0,1,1,0,0,0,
            0,0,0,0,0,0,0,0,0,
            2,0,0,0,0,0,0,0,0
        ],
        "dropItems": [
            0,0,0,0,0,0,0,0,0,
            0,0,0,0,0,0,0,0,0,
            0,0,0,0,0,0,0,0,0,
            0,0,0,0,0,0,0,0,0,
            0,0,0,0,0,0,0,0,0,
            0,0,0,0,0,0,0,0,0,
            0,0,0,0,0,0,0,0,0,
            0,0,0,0,0,0,0,0,0,
            0,0,0,0,0,0,0,0,0
        ],
        "chains": [
            0,0,0,0,0,0,0,0,0,
            0,0,0,0,0,3,0,3,0,
            0,0,0,0,0,0,0,0,0,
            0,1,0,1,0,0,0,2,0,
            0,0,2,0,0,0,2,0,2,
            0,1,0,1,0,0,0,2,0,
            0,0,1,0,1,0,0,0,0,
            0,3,0,3,0,3,0,3,0,
            0,0,2,0,2,0,0,0,0
        ],
        "hiddenItems": [
            0,0,0,0,0,8,8,8,0,
            0,0,0,0,0,8,8,8,0,
            0,0,0,0,0,8,8,8,0,
            0,5,5,5,0,0,7,7,7,
            0,5,5,5,0,0,7,7,7,
            0,5,5,5,0,0,7,7,7,
            0,0,0,6,6,6,0,0,0,
            0,0,0,6,6,6,0,0,0,
            0,0,0,6,6,6,0,0,0
        ],
        "gemColors": [
            8,8,8,8,0,0,0,0,0,
            8,8,8,8,0,8,0,8,0,
            8,8,8,8,0,0,0,0,0,
            0,8,8,8,0,8,0,8,0,
            0,0,8,0,0,8,8,0,8,
            0,8,0,8,0,8,0,8,0,
            8,0,8,0,8,0,0,0,0,
            0,8,0,8,0,8,0,8,0,
            8,0,8,0,8,0,0,0,0
        ],
        "gemTypes": [
            0,0,0,0,0,0,0,0,0,
            0,0,0,0,0,0,0,0,0,
            0,0,0,0,0,0,0,0,0,
            0,0,0,0,0,1,0,0,0,
            0,0,0,0,0,1,0,0,0,
            0,0,0,0,0,1,0,0,0,
            1,0,0,0,0,0,0,0,0,
            0,0,0,0,0,0,0,0,0,
            1,0,0,0,0,0,0,0,0
        ],
        "gemModifier": [
            0,0,0,0,0,0,0,0,0,
            0,0,0,0,0,0,0,0,0,
            0,0,0,0,0,0,0,0,0,
            0,0,0,0,0,0,0,0,0,
            0,0,0,0,0,0,0,0,0,
            0,0,0,0,0,0,0,0,0,
            0,0,0,0,0,0,0,0,0,
            0,0,0,0,0,0,0,0,0,
            0,0,0,0,0,0,0,0,0
        ],
        "gemDirection": [
            0,0,0,0,0,0,0,0,0,
            0,0,0,0,0,0,0,0,0,
            0,0,0,0,0,0,0,0,0,
            0,0,0,0,0,0,0,0,0,
            0,0,0,0,0,0,0,0,0,
            0,0,0,0,0,0,0,0,0,
            0,0,0,0,0,0,0,0,0,
            0,0,0,0,0,0,0,0,0,
            0,0,0,0,0,0,0,0,0
        ],
        "portals": [
            0,0,0,0,0,0,0,0,0,
            0,0,0,0,0,0,0,0,0,
            0,0,0,0,0,0,0,0,0,
            0,0,0,0,0,0,0,0,0,
            0,0,0,0,0,0,0,0,0,
            0,0,0,0,0,0,0,0,0,
            0,0,0,0,0,0,0,0,0,
            0,0,0,0,0,0,0,0,0,
            0,0,0,0,0,0,0,0,0
        ],
        "crates": [
            0,0,0,0,0,0,0,0,0,
            0,0,0,0,0,0,0,0,0,
            0,0,0,0,0,0,0,0,0,
            0,0,0,0,0,0,0,0,0,
            0,0,0,0,0,0,0,0,0,
            0,0,0,0,0,0,0,0,0,
            0,0,0,0,0,0,0,0,0,
            0,0,0,0,0,0,0,0,0,
            0,0,0,0,0,0,0,0,0
        ],
        "climbers": [
            0,0,0,0,0,0,0,0,0,
            0,0,0,0,0,0,0,0,0,
            0,0,0,0,0,0,0,0,0,
            0,0,0,0,0,0,0,0,0,
            0,0,0,0,0,0,0,0,0,
            0,0,0,0,0,0,0,0,0,
            0,0,0,0,0,0,0,0,0,
            0,0,0,0,0,0,0,0,0,
            0,0,0,0,0,0,0,0,0
        ]
    },
    "collectable": ""
}
