{
    "data": {
        "moves": 26,
        "gems": [
            {
                "type": "coins",
                "amount": 25
            },
            {
                "type": "green",
                "amount": 25
            },
            {
                "type": "orange",
                "amount": 25
            },
            {
                "type": "purple",
                "amount": 25
            },
            {
                "type": "red",
                "amount": 25
            },
            {
                "type": "yellow",
                "amount": 7
            }
        ],
        "objectives": [
            
        ],
        "spawnRatioDroppable": {
            "gemColor": 0,
            "gemType": 0,
            "minSpawn": 0,
            "maxSpawn": 0,
            "probability": 0
        },
        "spawnRatios": [
            
        ],
        "hiddenItemName": "monkey"
    },
    "layout": {
        "fields": [
            1,1,1,1,1,1,1,1,1,
            1,1,1,1,1,1,1,1,1,
            1,1,1,1,1,1,1,1,1,
            1,1,1,1,1,1,1,1,1,
            1,1,1,1,1,1,1,1,1,
            1,1,1,1,1,1,1,1,1,
            1,1,1,1,1,1,1,1,1,
            1,1,1,1,1,1,1,1,1,
            1,1,1,1,1,1,1,1,1
        ],
        "tiles": [
            2,2,2,2,2,2,2,2,2,
            2,2,2,2,2,2,2,2,2,
            2,2,2,2,2,2,2,2,2,
            2,2,2,2,2,2,2,2,2,
            2,2,2,2,2,2,2,2,2,
            2,2,2,2,2,2,2,2,2,
            2,2,2,2,2,2,2,2,2,
            2,2,2,2,2,2,2,2,2,
            2,2,2,2,2,2,2,2,2
        ],
        "stones": [
            0,0,0,0,0,0,0,0,0,
            0,0,0,0,0,0,0,0,0,
            0,0,0,0,0,0,0,0,0,
            0,0,0,0,0,0,0,0,0,
            0,0,0,0,0,0,0,0,0,
            0,0,0,0,0,0,0,0,0,
            0,0,0,0,0,0,0,0,0,
            0,0,0,0,0,0,0,0,0,
            0,0,0,0,0,0,0,0,0
        ],
        "spawning": [
            1,1,1,1,1,1,1,1,1,
            0,0,0,0,0,0,0,0,0,
            0,0,0,0,0,0,0,0,0,
            0,0,0,0,0,0,0,0,0,
            0,0,0,0,0,0,0,0,0,
            0,0,0,0,0,0,0,0,0,
            0,0,0,0,0,0,0,0,0,
            0,0,0,0,0,0,0,0,0,
            0,0,0,0,0,0,0,0,0
        ],
        "dropItems": [
            0,0,0,0,0,0,0,0,0,
            0,0,0,0,0,0,0,0,0,
            0,0,0,0,0,0,0,0,0,
            0,0,0,0,0,0,0,0,0,
            0,0,0,0,0,0,0,0,0,
            0,0,0,0,0,0,0,0,0,
            0,0,0,0,0,0,0,0,0,
            0,0,0,0,0,0,0,0,0,
            0,0,0,0,0,0,0,0,0
        ],
        "chains": [
            0,0,0,0,0,0,0,0,0,
            0,0,0,0,0,0,0,0,0,
            0,0,0,0,0,0,0,0,0,
            0,0,0,0,0,0,0,0,0,
            0,0,0,0,0,0,0,0,0,
            0,0,0,0,0,0,0,0,0,
            0,0,0,0,0,0,0,0,0,
            0,0,0,0,0,0,0,0,0,
            0,0,0,0,0,0,0,0,0
        ],
        "hiddenItems": [
            2,2,2,2,0,1,1,1,1,
            2,2,2,2,0,1,1,1,1,
            2,2,2,2,0,1,1,1,1,
            2,2,2,2,0,1,1,1,1,
            0,0,0,0,0,0,0,0,0,
            8,8,8,8,0,7,7,7,7,
            8,8,8,8,0,7,7,7,7,
            8,8,8,8,0,7,7,7,7,
            8,8,8,8,0,7,7,7,7
        ],
        "gemColors": [
            8,8,8,8,8,8,8,8,8,
            8,8,6,8,8,8,1,8,8,
            9,8,8,8,8,8,8,8,2,
            8,8,5,8,8,8,9,8,8,
            8,8,8,8,8,8,8,8,8,
            8,8,8,8,8,8,8,8,8,
            8,2,8,8,8,8,8,6,8,
            8,8,8,8,8,8,8,8,8,
            8,8,8,8,8,8,8,8,8
        ],
        "gemTypes": [
            0,0,0,0,0,0,0,0,0,
            0,0,10,0,0,0,10,0,0,
            10,0,0,0,0,0,0,0,10,
            0,0,10,0,0,0,10,0,0,
            0,0,0,0,0,0,0,0,0,
            0,0,0,0,0,0,0,0,0,
            0,10,0,0,0,0,0,10,0,
            0,0,0,0,0,0,0,0,0,
            0,0,0,0,0,0,0,0,0
        ],
        "gemModifier": [
            0,0,0,0,0,0,0,0,0,
            0,0,9,0,0,0,9,0,0,
            9,0,0,0,0,0,0,0,9,
            0,0,9,0,0,0,9,0,0,
            0,0,0,0,0,0,0,0,0,
            0,0,0,0,0,0,0,0,0,
            0,7,0,0,0,0,0,7,0,
            0,0,0,0,0,0,0,0,0,
            0,0,0,0,0,0,0,0,0
        ],
        "portals": [
            0,0,0,0,0,0,0,0,0,
            0,0,0,0,0,0,0,0,0,
            0,0,0,0,0,0,0,0,0,
            0,0,0,0,0,0,0,0,0,
            0,0,0,0,0,0,0,0,0,
            0,0,0,0,0,0,0,0,0,
            0,0,0,0,0,0,0,0,0,
            0,0,0,0,0,0,0,0,0,
            0,0,0,0,0,0,0,0,0
        ],
        "crates": [
            3,3,3,1,0,1,3,3,3,
            3,3,1,1,0,1,1,3,3,
            1,3,3,1,0,1,3,3,1,
            3,3,1,1,0,1,1,3,3,
            3,3,3,1,0,1,3,3,3,
            1,1,1,1,0,1,1,1,1,
            0,0,0,0,0,0,0,0,0,
            0,0,0,0,0,0,0,0,0,
            0,0,0,0,0,0,0,0,0
        ],
        "climbers": [
            0,0,0,0,0,0,0,0,0,
            0,0,0,0,0,0,0,0,0,
            0,0,0,0,0,0,0,0,0,
            0,0,0,0,0,0,0,0,0,
            0,0,0,0,0,0,0,0,0,
            0,0,0,0,0,0,0,0,0,
            0,0,0,0,0,0,0,0,0,
            0,0,0,0,0,0,0,0,0,
            0,0,0,0,0,0,0,0,0
        ]
    },
    "collectable": ""
}
