{
    "data": {
        "moves": 31,
        "gems": [
            {
                "type": "coins",
                "amount": 25
            },
            {
                "type": "orange",
                "amount": 25
            },
            {
                "type": "green",
                "amount": 25
            },
            {
                "type": "yellow",
                "amount": 25
            },
            {
                "type": "red",
                "amount": 25
            },
            {
                "type": "purple",
                "amount": 2
            }
        ],
        "objectives": [
            
        ],
        "spawnRatioDroppable": {
            "gemColor": 0,
            "gemType": 0,
            "minSpawn": 0,
            "maxSpawn": 0,
            "probability": 0
        },
        "spawnRatios": [
            
        ],
        "hiddenItemName": "monkey"
    },
    "layout": {
        "fields": [
            1,1,1,1,1,1,1,1,1,
            1,1,1,1,1,1,1,1,1,
            1,1,1,1,1,1,1,1,1,
            1,1,1,0,0,0,1,1,1,
            0,1,1,1,0,1,1,1,0,
            1,1,1,1,1,1,1,1,1,
            1,1,1,1,1,1,1,1,1,
            1,1,1,1,1,1,1,1,1,
            1,1,1,1,1,1,1,1,1
        ],
        "tiles": [
            0,0,0,2,2,2,0,0,0,
            1,2,2,2,2,2,2,2,1,
            1,2,2,2,2,2,2,2,1,
            1,2,2,0,0,0,2,2,1,
            0,0,0,0,0,0,0,0,0,
            1,1,1,1,1,1,1,1,1,
            1,1,1,1,1,1,1,1,1,
            1,1,1,1,1,1,1,1,1,
            0,0,0,0,0,0,0,0,0
        ],
        "stones": [
            0,0,0,0,0,0,0,0,0,
            0,0,0,0,0,0,0,0,0,
            0,0,0,0,0,0,0,0,0,
            0,0,0,0,0,0,0,0,0,
            0,0,0,0,0,0,0,0,0,
            0,0,0,0,0,0,0,0,0,
            0,0,0,0,0,0,0,0,0,
            0,0,0,0,0,0,0,0,0,
            0,0,0,0,0,0,0,0,0
        ],
        "spawning": [
            1,1,1,1,1,1,1,1,1,
            0,0,0,0,0,0,0,0,0,
            0,0,0,0,0,0,0,0,0,
            0,0,0,0,0,0,0,0,0,
            0,0,0,0,0,0,0,0,0,
            0,0,0,0,0,0,0,0,0,
            0,0,0,0,0,0,0,0,0,
            0,0,0,0,0,0,0,0,0,
            0,0,0,0,0,0,0,0,0
        ],
        "dropItems": [
            0,0,0,0,0,0,0,0,0,
            0,0,0,0,0,0,0,0,0,
            0,0,0,0,0,0,0,0,0,
            0,0,0,0,0,0,0,0,0,
            0,0,0,0,0,0,0,0,0,
            0,0,0,0,0,0,0,0,0,
            0,0,0,0,0,0,0,0,0,
            0,0,0,0,0,0,0,0,0,
            0,0,0,0,0,0,0,0,0
        ],
        "chains": [
            0,0,0,0,0,0,0,0,0,
            0,0,0,0,0,0,0,0,0,
            0,0,0,0,0,0,0,0,0,
            0,0,0,0,0,0,0,0,0,
            0,0,0,0,0,0,0,0,0,
            0,0,0,0,0,0,0,0,0,
            0,0,0,0,0,0,0,0,0,
            0,0,0,0,0,0,0,0,0,
            0,0,0,0,0,0,0,0,0
        ],
        "hiddenItems": [
            0,0,0,8,8,0,0,0,0,
            0,6,6,8,8,0,0,1,1,
            0,6,6,0,0,0,0,1,1,
            0,0,0,0,0,0,0,0,0,
            0,0,0,0,0,0,0,0,0,
            5,5,0,0,0,7,7,7,0,
            5,5,0,0,0,7,7,7,0,
            0,0,0,0,0,7,7,7,0,
            0,0,0,0,0,0,0,0,0
        ],
        "gemColors": [
            1,8,5,8,4,8,5,8,1,
            8,14,1,4,8,4,1,14,8,
            5,14,5,1,8,1,5,13,5,
            8,13,14,0,0,0,13,14,8,
            0,14,5,13,0,14,5,13,0,
            8,13,14,14,4,14,13,14,8,
            8,14,5,13,4,14,5,13,8,
            8,14,13,14,4,13,14,14,8,
            8,5,9,5,1,5,9,5,8
        ],
        "gemTypes": [
            2,0,0,0,1,0,0,0,2,
            0,0,0,0,0,0,0,0,0,
            0,0,1,0,2,0,1,0,0,
            0,0,0,0,0,0,0,0,0,
            0,0,3,0,0,0,2,0,0,
            0,0,0,0,1,0,0,0,0,
            0,0,3,0,2,0,3,0,0,
            0,0,0,0,3,0,0,0,0,
            0,0,0,0,1,0,0,0,0
        ],
        "gemModifier": [
            0,0,0,0,0,0,0,0,0,
            0,6,0,0,0,0,0,6,0,
            0,5,0,0,0,0,0,5,0,
            0,6,5,0,0,0,5,6,0,
            0,5,0,5,0,5,0,5,0,
            0,4,5,4,0,4,5,4,0,
            0,4,0,4,0,4,0,4,0,
            0,5,5,5,0,5,5,5,0,
            0,0,0,0,0,0,0,0,0
        ],
        "portals": [
            0,0,0,0,0,0,0,0,0,
            0,0,0,0,0,0,0,0,0,
            0,0,0,0,0,0,0,0,0,
            0,0,0,0,0,0,0,0,0,
            0,0,0,0,0,0,0,0,0,
            0,0,0,0,0,0,0,0,0,
            0,0,0,0,0,0,0,0,0,
            0,0,0,0,0,0,0,0,0,
            0,0,0,0,0,0,0,0,0
        ],
        "crates": [
            0,1,1,1,0,1,1,1,0,
            1,0,0,0,1,0,0,0,1,
            1,0,3,0,1,0,3,0,1,
            1,0,0,0,0,0,0,0,1,
            0,0,3,0,0,0,3,0,0,
            0,0,0,0,0,0,0,0,0,
            0,0,1,0,0,0,1,0,0,
            0,0,0,0,1,0,0,0,0,
            0,1,1,1,0,1,1,1,0
        ],
        "climbers": [
            0,0,0,0,0,0,0,0,0,
            0,0,0,0,0,0,0,0,0,
            0,0,0,0,0,0,0,0,0,
            0,0,0,0,0,0,0,0,0,
            0,0,0,0,0,0,0,0,0,
            0,0,0,0,0,0,0,0,0,
            0,0,0,0,0,0,0,0,0,
            0,0,0,0,0,0,0,0,0,
            0,1,0,0,1,0,0,1,0
        ]
    },
    "collectable": ""
}
