{
    "data": {
        "moves": 27,
        "gems": [
            {
                "type": "coins",
                "amount": 25
            },
            {
                "type": "orange",
                "amount": 25
            },
            {
                "type": "red",
                "amount": 25
            },
            {
                "type": "yellow",
                "amount": 25
            },
            {
                "type": "green",
                "amount": 25
            },
            {
                "type": "purple",
                "amount": 3
            }
        ],
        "objectives": [
            {
                "type": "climber",
                "amount": 2
            }
        ],
        "spawnRatioDroppable": {
            "gemColor": 0,
            "gemType": 0,
            "minSpawn": 0,
            "maxSpawn": 0,
            "probability": 0
        },
        "spawnRatios": [
            {
                "gemColor": 8,
                "gemType": 6,
                "minSpawn": 3,
                "maxSpawn": 7,
                "probability": 5
            }
        ],
        "hiddenItemName": "monkey"
    },
    "layout": {
        "fields": [
            0,0,0,1,1,1,0,0,0,
            0,0,1,1,1,1,1,0,0,
            0,1,1,1,1,1,1,1,0,
            1,1,1,1,1,1,1,1,1,
            1,1,1,1,1,1,1,1,1,
            1,1,1,1,1,1,1,1,1,
            1,1,1,1,1,1,1,1,1,
            1,1,1,1,1,1,1,1,1,
            1,1,1,1,1,1,1,1,1
        ],
        "tiles": [
            0,0,0,1,1,1,0,0,0,
            0,0,0,1,1,1,2,0,0,
            0,0,0,1,1,1,2,2,0,
            0,0,0,1,1,1,2,2,2,
            0,0,0,1,1,1,2,2,2,
            0,0,0,1,1,1,2,2,2,
            0,0,0,1,1,1,2,2,2,
            0,0,0,1,1,1,2,2,2,
            0,0,0,1,1,1,2,2,2
        ],
        "stones": [
            0,0,0,0,0,0,0,0,0,
            0,0,0,0,0,0,0,0,0,
            0,0,0,0,0,0,0,0,0,
            0,0,0,0,0,0,0,0,0,
            0,0,0,0,0,0,0,0,0,
            0,0,0,0,0,0,0,0,0,
            0,0,0,0,0,0,0,0,0,
            0,0,0,0,0,0,0,0,0,
            0,0,0,0,0,0,0,0,0
        ],
        "spawning": [
            0,0,0,1,1,1,0,0,0,
            0,0,1,0,0,0,0,0,0,
            0,1,0,0,0,0,0,0,0,
            1,0,0,0,0,0,0,0,0,
            0,0,0,0,0,0,0,0,0,
            0,0,0,0,0,0,0,0,0,
            0,0,0,0,0,0,0,0,0,
            0,0,0,0,0,0,0,0,0,
            0,0,0,0,0,0,0,0,0
        ],
        "dropItems": [
            0,0,0,0,0,0,0,0,0,
            0,0,0,0,0,0,0,0,0,
            0,0,0,0,0,0,0,0,0,
            0,0,0,0,0,0,0,0,0,
            0,0,0,0,0,0,0,0,0,
            0,0,0,0,0,0,0,0,0,
            0,0,0,0,0,0,0,0,0,
            0,0,0,0,0,0,0,0,0,
            0,0,0,0,0,0,0,0,0
        ],
        "chains": [
            0,0,0,2,2,2,0,0,0,
            0,0,0,2,0,0,2,0,0,
            0,0,0,2,0,0,2,0,0,
            0,0,0,2,0,0,2,0,0,
            0,0,0,2,0,0,2,0,0,
            0,0,0,3,3,3,3,0,0,
            0,0,0,3,0,0,3,0,0,
            0,0,0,3,0,0,3,0,0,
            0,0,0,3,3,3,3,0,0
        ],
        "hiddenItems": [
            0,0,0,6,6,0,0,0,0,
            0,0,0,6,6,0,0,0,0,
            0,0,0,0,0,8,8,0,0,
            0,0,0,7,7,8,8,0,0,
            0,0,0,7,7,0,0,1,1,
            0,0,0,0,0,0,0,1,1,
            0,0,0,0,0,0,2,2,2,
            0,0,0,5,5,0,2,2,2,
            0,0,0,5,5,0,2,2,2
        ],
        "gemColors": [
            0,0,0,8,2,8,0,0,0,
            0,0,8,8,0,0,8,0,0,
            0,8,8,8,0,0,2,0,0,
            8,8,8,2,0,0,8,0,0,
            8,8,8,8,12,0,2,0,0,
            8,8,8,2,8,8,8,0,0,
            8,8,8,8,0,0,8,0,0,
            8,8,8,2,0,0,8,0,0,
            8,8,8,8,2,8,2,0,0
        ],
        "gemTypes": [
            0,0,0,6,0,0,0,0,0,
            0,0,0,0,0,0,0,0,0,
            0,0,0,6,0,0,0,0,0,
            0,6,0,0,0,0,6,0,0,
            0,0,0,6,0,0,0,0,0,
            0,6,0,0,0,0,6,0,0,
            0,0,0,6,0,0,0,0,0,
            0,6,0,0,0,0,6,0,0,
            0,0,0,6,0,0,0,0,0
        ],
        "gemModifier": [
            
        ],
        "portals": [
            0,0,0,0,0,0,0,0,0,
            0,0,0,0,0,0,2,0,0,
            0,0,0,0,0,0,0,4,0,
            0,0,0,0,0,0,0,0,6,
            0,0,0,0,0,0,0,0,0,
            0,0,0,0,0,0,0,0,0,
            0,0,0,0,0,0,0,0,0,
            0,0,0,0,0,0,0,0,0,
            0,0,0,1,3,5,0,0,0
        ],
        "crates": [
            0,0,0,0,0,0,0,0,0,
            0,0,0,0,0,0,0,0,0,
            0,0,0,0,0,0,0,0,0,
            0,0,0,0,0,0,0,0,0,
            0,0,0,0,0,0,0,0,0,
            0,0,0,0,0,0,0,0,0,
            0,0,0,0,0,0,0,0,0,
            0,0,0,0,0,0,0,0,0,
            0,0,0,0,0,0,0,0,0
        ],
        "climbers": [
            0,0,0,2,2,2,0,0,0,
            0,0,2,0,0,0,0,0,0,
            0,2,0,0,0,0,0,0,0,
            2,0,0,0,0,0,0,0,0,
            0,0,0,0,0,0,0,0,0,
            0,0,0,0,0,0,0,0,0,
            0,0,0,0,0,0,0,0,0,
            0,0,0,0,0,0,0,0,0,
            0,0,0,0,0,0,1,1,0
        ]
    },
    "collectable": ""
}
