{
    "data": {
        "moves": 34,
        "gems": [
            {
                "type": "coins",
                "amount": 25
            },
            {
                "type": "orange",
                "amount": 25
            },
            {
                "type": "red",
                "amount": 25
            },
            {
                "type": "purple",
                "amount": 25
            },
            {
                "type": "green",
                "amount": 8
            }
        ],
        "objectives": [
            {
                "type": "climber",
                "amount": 4
            },
            {
                "type": "droppable",
                "amount": 4
            }
        ],
        "spawnRatioDroppable": {
            "gemColor": 7,
            "gemType": 0,
            "minSpawn": 1,
            "maxSpawn": 3,
            "probability": 3
        },
        "spawnRatios": [
            {
                "gemColor": 8,
                "gemType": 6,
                "minSpawn": 2,
                "maxSpawn": 8,
                "probability": 5
            }
        ],
        "hiddenItemName": "monkey"
    },
    "layout": {
        "fields": [
            1,1,0,1,1,1,1,1,1,
            1,1,0,1,1,1,1,1,1,
            1,1,0,1,1,1,1,1,1,
            1,1,0,1,1,1,1,1,1,
            1,1,0,1,1,1,0,1,1,
            1,1,1,1,1,1,0,1,1,
            1,1,1,1,1,1,0,1,1,
            1,1,1,1,1,1,0,1,1,
            1,1,1,1,1,1,0,1,1
        ],
        "tiles": [
            0,0,0,0,0,0,0,0,0,
            0,0,0,0,0,0,0,0,0,
            0,0,0,0,0,0,0,0,0,
            0,0,0,0,0,0,0,0,0,
            0,0,0,0,0,0,0,0,0,
            0,0,0,0,0,0,0,0,0,
            0,0,0,0,0,0,0,0,0,
            0,0,0,0,0,0,0,0,0,
            0,0,0,0,0,0,0,0,0
        ],
        "stones": [
            0,0,0,0,0,0,0,0,0,
            0,0,0,0,0,0,0,0,0,
            0,0,0,0,0,0,0,0,0,
            0,0,0,0,0,0,0,0,0,
            0,0,0,0,0,0,0,0,0,
            0,0,0,0,0,0,0,0,0,
            0,0,0,0,0,0,0,0,0,
            0,0,0,0,0,0,0,0,0,
            0,0,0,0,0,0,0,0,0
        ],
        "spawning": [
            0,0,0,1,1,1,1,1,1,
            0,0,0,0,0,0,0,0,0,
            0,0,0,0,0,0,0,0,0,
            0,0,0,0,0,0,0,0,0,
            0,0,0,0,0,0,0,0,0,
            0,0,0,0,0,0,0,0,0,
            0,0,0,0,0,0,0,0,0,
            0,0,0,0,0,0,0,0,0,
            0,0,0,0,0,0,0,0,0
        ],
        "dropItems": [
            1,1,0,0,0,0,0,0,0,
            0,0,0,0,0,0,0,0,0,
            0,0,0,0,0,0,0,0,0,
            0,0,0,0,0,0,0,0,0,
            0,0,0,0,0,0,0,0,0,
            0,0,0,0,0,0,0,0,0,
            0,0,0,0,0,0,0,0,0,
            0,0,0,0,0,0,0,0,0,
            2,2,2,2,2,2,0,0,0
        ],
        "chains": [
            0,0,0,0,0,0,0,0,0,
            0,0,0,0,0,0,0,0,0,
            0,0,0,0,0,0,0,0,0,
            0,0,0,0,0,0,0,0,0,
            0,0,0,0,0,0,0,0,0,
            0,0,0,0,0,0,0,0,0,
            0,0,0,0,0,0,0,0,0,
            0,0,0,0,0,0,0,0,0,
            0,0,0,0,0,0,0,0,0
        ],
        "hiddenItems": [
            0,0,0,0,0,0,0,0,0,
            0,0,0,0,0,0,0,0,0,
            0,0,0,0,0,0,0,0,0,
            0,0,0,0,0,0,0,0,0,
            0,0,0,0,0,0,0,0,0,
            0,0,0,0,0,0,0,0,0,
            0,0,0,0,0,0,0,0,0,
            0,0,0,0,0,0,0,0,0,
            0,0,0,0,0,0,0,0,0
        ],
        "gemColors": [
            7,8,0,8,8,8,8,8,8,
            8,8,0,8,8,8,8,8,8,
            8,8,0,8,8,8,8,8,8,
            8,8,0,8,8,8,8,8,8,
            8,8,0,8,8,8,0,8,8,
            8,8,8,8,8,8,0,8,8,
            8,8,8,8,8,8,0,8,8,
            8,8,8,8,8,8,0,8,8,
            8,8,8,8,8,8,0,8,12
        ],
        "gemTypes": [
            0,0,0,0,0,0,1,0,1,
            0,6,0,0,0,0,6,1,0,
            6,0,0,0,6,0,1,0,1,
            0,6,0,0,0,0,6,1,0,
            6,0,0,0,0,0,0,6,0,
            6,0,6,0,0,0,0,0,1,
            6,6,1,0,1,0,0,6,0,
            2,6,6,0,0,0,0,0,1,
            6,2,6,0,0,0,0,6,0
        ],
        "gemModifier": [
            2,0,0,0,0,0,0,0,0,
            0,2,0,0,0,0,0,2,0,
            2,0,0,0,2,0,0,0,0,
            0,2,0,0,0,0,0,0,0,
            2,0,0,0,0,0,0,2,0,
            0,0,0,0,0,0,0,0,2,
            0,2,0,0,2,0,0,2,0,
            0,0,0,0,0,0,0,0,2,
            0,0,0,0,0,0,0,2,0
        ],
        "portals": [
            0,0,0,0,0,0,0,0,0,
            0,0,0,0,0,0,0,0,0,
            0,0,0,0,0,0,0,0,0,
            0,0,0,0,0,0,0,0,0,
            0,0,0,0,0,0,0,0,0,
            0,0,0,0,0,0,0,0,0,
            0,0,0,0,0,0,0,0,0,
            0,0,0,0,0,0,0,0,0,
            0,0,0,0,0,0,0,0,0
        ],
        "crates": [
            0,0,0,0,0,0,21,22,21,
            0,0,0,0,0,0,21,0,21,
            0,0,0,0,0,0,21,22,21,
            0,0,0,0,0,0,21,22,21,
            0,0,0,0,0,0,0,0,0,
            25,26,25,0,0,0,0,0,0,
            25,0,25,0,0,0,0,0,0,
            25,26,25,0,0,0,0,0,0,
            25,26,25,0,0,0,0,0,0
        ],
        "climbers": [
            0,0,0,2,2,2,2,2,2,
            0,0,0,0,0,0,0,0,0,
            0,0,0,0,0,0,0,0,0,
            0,0,0,0,0,0,0,0,0,
            0,0,0,0,0,0,0,0,0,
            0,0,0,0,0,0,0,0,0,
            0,0,0,0,0,0,0,0,0,
            0,0,0,0,0,0,0,0,0,
            0,0,0,0,0,0,0,1,1
        ]
    },
    "collectable": ""
}
