{
    "data": {
        "moves": 30,
        "gems": [
            {
                "type": "coins",
                "amount": 25
            },
            {
                "type": "red",
                "amount": 25
            },
            {
                "type": "orange",
                "amount": 25
            },
            {
                "type": "purple",
                "amount": 25
            },
            {
                "type": "green",
                "amount": 7
            }
        ],
        "objectives": [
            {
                "type": "climber",
                "amount": 1
            }
        ],
        "spawnRatioDroppable": {
            "gemColor": 0,
            "gemType": 0,
            "minSpawn": 0,
            "maxSpawn": 0,
            "probability": 0
        },
        "spawnRatios": [
            {
                "gemColor": 8,
                "gemType": 6,
                "minSpawn": 1,
                "maxSpawn": 2,
                "probability": 5
            }
        ],
        "hiddenItemName": "monkey"
    },
    "layout": {
        "fields": [
            0,1,0,0,1,0,1,1,1,
            1,1,1,1,1,1,1,1,1,
            1,1,1,0,1,0,1,1,1,
            1,1,1,0,1,0,1,1,1,
            1,1,1,0,1,0,1,1,1,
            1,1,1,0,1,0,1,1,1,
            1,1,1,0,1,0,1,1,1,
            1,1,1,0,1,0,1,1,1,
            1,1,1,0,1,0,1,1,1
        ],
        "tiles": [
            0,3,0,0,0,0,0,0,0,
            0,0,0,0,0,0,0,0,0,
            0,3,0,0,0,0,0,0,0,
            0,0,0,0,0,0,0,0,0,
            0,3,0,0,0,0,0,0,0,
            0,0,0,0,0,0,0,0,0,
            0,3,0,0,0,0,0,0,0,
            0,0,0,0,0,0,0,0,0,
            0,3,0,0,0,0,0,0,0
        ],
        "stones": [
            0,0,0,0,0,0,0,0,0,
            0,0,0,0,0,0,0,0,0,
            0,0,0,0,0,0,0,0,0,
            0,0,0,0,0,0,0,0,0,
            0,0,0,0,0,0,0,0,0,
            0,0,0,0,0,0,0,0,0,
            0,0,0,0,0,0,0,0,0,
            0,0,0,0,0,0,0,0,0,
            0,0,0,0,0,0,0,0,0
        ],
        "spawning": [
            0,0,0,0,1,0,1,0,1,
            1,0,0,1,0,1,0,0,0,
            0,0,0,0,0,0,0,0,0,
            0,0,0,0,0,0,0,0,0,
            0,0,0,0,0,0,0,0,0,
            0,0,0,0,0,0,0,0,0,
            0,0,0,0,0,0,0,0,0,
            0,0,0,0,0,0,0,0,0,
            0,0,0,0,0,0,0,0,0
        ],
        "dropItems": [
            0,0,0,0,0,0,0,0,0,
            0,0,0,0,0,0,0,0,0,
            0,0,0,0,0,0,0,0,0,
            0,0,0,0,0,0,0,0,0,
            0,0,0,0,0,0,0,0,0,
            0,0,0,0,0,0,0,0,0,
            0,0,0,0,0,0,0,0,0,
            0,0,0,0,0,0,0,0,0,
            0,0,0,0,0,0,0,0,0
        ],
        "chains": [
            0,0,0,0,3,0,0,3,0,
            3,0,2,1,3,1,0,3,0,
            3,0,2,0,3,0,0,1,0,
            3,0,3,0,3,0,0,0,0,
            3,0,3,0,3,0,0,0,0,
            3,0,3,0,3,0,0,0,0,
            3,0,3,0,3,0,0,1,0,
            2,0,3,0,3,0,0,3,0,
            2,0,3,0,0,0,0,3,0
        ],
        "hiddenItems": [
            0,0,0,0,0,0,0,0,0,
            0,0,0,0,0,0,0,0,0,
            0,0,0,0,0,0,0,0,0,
            0,0,0,0,0,0,0,0,0,
            0,0,0,0,0,0,0,0,0,
            0,0,0,0,0,0,0,0,0,
            0,0,0,0,0,0,0,0,0,
            0,0,0,0,0,0,0,0,0,
            0,0,0,0,0,0,0,0,0
        ],
        "gemColors": [
            0,0,0,0,8,0,8,8,8,
            9,0,9,8,8,8,8,8,8,
            2,0,2,0,8,0,8,8,8,
            6,0,6,0,8,0,8,8,8,
            5,0,5,0,8,0,8,8,8,
            9,0,9,0,8,0,8,8,8,
            6,0,6,0,8,0,8,8,8,
            1,0,1,0,8,0,8,8,8,
            2,0,2,0,12,0,8,8,8
        ],
        "gemTypes": [
            0,0,0,0,0,0,0,6,0,
            1,0,0,0,0,0,0,6,0,
            0,0,1,0,0,0,0,6,0,
            0,0,0,0,0,0,0,6,0,
            0,0,0,0,0,0,0,6,0,
            1,0,0,0,0,0,0,6,0,
            0,0,1,0,0,0,0,6,0,
            1,0,0,0,0,0,0,6,0,
            0,0,1,0,0,0,0,6,0
        ],
        "gemModifier": [
            0,0,0,0,0,0,0,0,0,
            0,0,0,0,0,0,0,0,0,
            0,0,0,0,0,0,0,0,0,
            0,0,0,0,0,0,0,0,0,
            0,0,0,0,0,0,0,0,0,
            0,0,0,0,0,0,0,0,0,
            0,0,0,0,0,0,0,0,0,
            0,0,0,0,0,0,0,0,0,
            0,0,0,0,0,0,0,0,0
        ],
        "portals": [
            0,2,0,0,0,0,0,4,0,
            0,0,0,0,0,0,0,0,0,
            0,0,0,0,0,0,0,0,0,
            0,0,0,0,0,0,0,0,0,
            0,0,0,0,0,0,0,0,0,
            0,0,0,0,0,0,0,0,0,
            0,0,0,0,0,0,0,0,0,
            0,0,0,0,0,0,0,0,0,
            0,3,0,0,1,0,0,0,0
        ],
        "crates": [
            0,0,0,0,0,0,0,0,0,
            0,0,0,0,0,0,0,0,0,
            0,0,0,0,0,0,0,0,0,
            0,0,0,0,0,0,0,2,0,
            0,0,0,0,0,0,0,1,0,
            0,0,0,0,0,0,0,2,0,
            0,0,0,0,0,0,0,0,0,
            0,0,0,0,0,0,0,0,0,
            0,0,0,0,0,0,0,0,0
        ],
        "climbers": [
            0,0,0,0,2,0,0,0,0,
            0,0,0,2,0,2,0,0,0,
            0,0,0,0,0,0,0,0,0,
            0,0,0,0,0,0,0,0,0,
            0,0,0,0,0,0,0,0,0,
            0,0,0,0,0,0,0,0,0,
            0,0,0,0,0,0,0,0,0,
            0,0,0,0,0,0,0,0,0,
            0,0,0,0,0,0,0,0,0
        ]
    },
    "collectable": ""
}
