{
    "data": {
        "moves": 28,
        "gems": [
            {
                "type": "coins",
                "amount": 25
            },
            {
                "type": "yellow",
                "amount": 25
            },
            {
                "type": "red",
                "amount": 25
            },
            {
                "type": "green",
                "amount": 25
            },
            {
                "type": "orange",
                "amount": 25
            }
        ],
        "objectives": [
            {
                "type": "purple",
                "amount": 12
            }
        ],
        "spawnRatioDroppable": {
            "gemColor": 0,
            "gemType": 0,
            "minSpawn": 0,
            "maxSpawn": 0,
            "probability": 0
        },
        "spawnRatios": [
            
        ],
        "hiddenItemName": "monkey"
    },
    "layout": {
        "fields": [
            1,1,1,1,1,1,1,0,0,
            1,1,1,1,1,1,1,1,0,
            1,1,1,1,1,1,1,1,1,
            1,1,1,1,1,1,1,1,1,
            1,1,1,1,1,1,1,1,1,
            1,1,1,1,1,1,1,1,1,
            1,1,1,1,1,1,1,1,1,
            1,1,1,1,1,1,1,1,0,
            1,1,1,1,1,1,1,0,1
        ],
        "tiles": [
            0,0,0,0,0,0,0,0,0,
            0,0,0,0,0,0,0,0,0,
            0,0,0,0,0,0,0,0,0,
            0,0,0,0,0,0,0,0,0,
            0,0,0,0,0,0,0,0,0,
            0,0,0,0,0,0,0,0,0,
            0,0,0,0,0,0,0,0,0,
            0,0,0,0,0,0,0,0,0,
            0,0,0,0,0,0,0,0,0
        ],
        "stones": [
            0,0,0,0,8,0,0,0,0,
            0,0,0,8,0,0,0,0,0,
            0,0,8,0,0,0,0,0,0,
            0,8,0,0,0,0,0,0,0,
            8,0,0,0,0,0,0,0,0,
            0,8,0,0,0,0,0,0,0,
            8,0,0,0,0,0,0,0,0,
            0,0,0,8,0,0,0,0,0,
            0,0,8,0,0,0,0,0,8
        ],
        "spawning": [
            1,1,1,1,1,1,1,0,0,
            0,0,0,0,0,0,0,1,0,
            0,0,0,0,0,0,0,0,1,
            0,0,0,0,0,0,0,0,0,
            0,0,0,0,0,0,0,0,0,
            0,0,0,0,0,0,0,0,0,
            0,0,0,0,0,0,0,0,0,
            0,0,0,0,0,0,0,0,0,
            0,0,0,0,0,0,0,0,0
        ],
        "dropItems": [
            0,0,0,0,0,0,0,0,0,
            0,0,0,0,0,0,0,0,0,
            0,0,0,0,0,0,0,0,0,
            0,0,0,0,0,0,0,0,0,
            0,0,0,0,0,0,0,0,0,
            0,0,0,0,0,0,0,0,0,
            0,0,0,0,0,0,0,0,0,
            0,0,0,0,0,0,0,0,0,
            0,0,0,0,0,0,0,0,0
        ],
        "chains": [
            0,0,0,0,0,0,0,0,0,
            0,0,0,0,0,0,0,0,0,
            0,0,0,0,0,0,0,0,0,
            0,0,0,0,0,0,0,0,0,
            0,0,0,0,0,0,0,0,0,
            0,0,0,0,0,0,0,0,0,
            0,0,0,0,0,0,0,0,0,
            0,0,0,0,0,0,0,0,0,
            0,0,0,0,0,0,0,0,0
        ],
        "hiddenItems": [
            0,0,0,0,0,0,0,0,0,
            0,0,0,0,0,0,0,0,0,
            0,0,0,0,0,0,0,0,0,
            0,0,0,0,0,0,0,0,0,
            0,0,0,0,0,0,0,0,0,
            0,0,0,0,0,0,0,0,0,
            0,0,0,0,0,0,0,0,0,
            0,0,0,0,0,0,0,0,0,
            0,0,0,0,0,0,0,0,0
        ],
        "gemColors": [
            5,8,5,8,0,8,8,0,0,
            8,5,8,0,8,8,8,8,0,
            5,8,0,8,8,8,8,8,8,
            8,0,8,8,8,8,8,8,8,
            0,8,8,8,8,8,8,8,5,
            8,0,8,8,8,8,8,5,8,
            0,8,8,8,8,8,5,8,5,
            8,8,8,0,8,5,8,5,0,
            8,8,0,8,5,8,5,0,0
        ],
        "gemTypes": [
            0,1,0,1,0,0,0,0,0,
            2,0,3,0,2,0,0,0,0,
            0,2,0,0,0,0,0,0,0,
            3,0,2,0,0,0,0,0,0,
            0,0,0,0,0,0,0,1,0,
            2,0,0,0,0,0,0,0,0,
            0,0,0,0,0,1,0,3,0,
            0,0,0,0,0,0,0,0,0,
            0,0,0,1,0,3,0,0,0
        ],
        "gemModifier": [
            3,0,3,0,0,0,0,0,0,
            0,3,0,0,0,0,0,0,0,
            3,0,0,0,0,0,0,0,0,
            0,0,0,0,0,0,0,0,0,
            0,0,0,0,0,0,0,0,3,
            0,0,0,0,0,0,0,3,0,
            0,0,0,0,0,0,3,0,3,
            0,0,0,0,0,3,0,3,0,
            0,0,0,0,3,0,3,0,0
        ],
        "portals": [
            0,0,0,0,0,0,0,0,0,
            0,0,0,0,0,0,0,0,0,
            0,0,0,0,0,0,0,0,0,
            0,0,0,0,0,0,0,0,0,
            0,0,0,0,0,0,0,0,0,
            0,0,0,0,0,0,0,0,0,
            0,0,0,0,0,0,0,0,0,
            0,0,0,0,0,0,0,0,0,
            0,0,0,0,0,0,0,0,0
        ],
        "crates": [
            0,2,0,3,0,3,0,0,0,
            2,0,3,0,3,0,0,0,0,
            0,3,0,3,0,0,0,0,0,
            3,0,3,0,0,0,0,0,3,
            0,3,0,0,0,0,0,3,0,
            3,0,0,0,0,0,3,0,2,
            0,0,0,0,0,3,0,2,0,
            0,0,0,0,3,0,2,0,0,
            0,0,0,3,0,2,0,0,0
        ],
        "climbers": [
            0,0,0,0,0,0,0,0,0,
            0,0,0,0,0,0,0,0,0,
            0,0,0,0,0,0,0,0,0,
            0,0,0,0,0,0,0,0,0,
            0,0,0,0,0,0,0,0,0,
            0,0,0,0,0,0,0,0,0,
            0,0,0,0,0,0,0,0,0,
            0,0,0,0,0,0,0,0,0,
            0,0,0,0,0,0,0,0,0
        ]
    },
    "collectable": ""
}
