{
    "data": {
        "moves": 35,
        "gems": [
            {
                "type": "coins",
                "amount": 25
            },
            {
                "type": "purple",
                "amount": 25
            },
            {
                "type": "red",
                "amount": 25
            },
            {
                "type": "blue",
                "amount": 25
            },
            {
                "type": "green",
                "amount": 5
            }
        ],
        "objectives": [
            {
                "type": "climber",
                "amount": 2
            }
        ],
        "spawnRatioDroppable": {
            "gemColor": 0,
            "gemType": 0,
            "minSpawn": 0,
            "maxSpawn": 0,
            "probability": 0
        },
        "spawnRatios": [
            {
                "gemColor": 8,
                "gemType": 6,
                "minSpawn": 2,
                "maxSpawn": 4,
                "probability": 3
            }
        ],
        "hiddenItemName": "monkey"
    },
    "layout": {
        "fields": [
            1,1,0,0,0,1,1,1,1,
            1,1,1,1,0,1,1,1,1,
            1,1,1,1,1,1,2,1,1,
            1,1,1,1,1,1,1,1,1,
            1,1,1,1,1,1,1,1,1,
            1,1,1,1,1,1,1,1,1,
            1,1,1,1,1,1,2,1,1,
            1,1,1,1,0,1,1,1,1,
            1,1,0,0,0,1,1,1,1
        ],
        "tiles": [
            0,0,0,0,0,0,2,2,2,
            0,0,2,2,0,0,2,2,2,
            0,0,2,2,0,0,0,0,0,
            0,0,2,2,0,0,2,2,2,
            0,0,2,2,0,0,2,2,2,
            0,0,2,2,0,0,2,2,2,
            0,0,2,2,0,0,0,0,0,
            0,0,2,2,0,0,2,2,2,
            0,0,0,0,0,0,2,2,2
        ],
        "stones": [
            0,0,0,0,0,0,0,0,0,
            0,0,0,0,0,0,0,0,0,
            0,0,0,0,0,0,0,0,0,
            0,0,0,0,0,0,0,0,0,
            0,0,0,0,0,0,0,0,0,
            0,0,0,0,0,0,0,0,0,
            0,0,0,0,0,0,0,0,0,
            0,0,0,0,0,0,0,0,0,
            0,0,0,0,0,0,0,0,0
        ],
        "spawning": [
            1,1,0,0,0,1,1,1,1,
            0,0,1,1,0,0,0,0,0,
            0,0,0,0,1,0,0,0,0,
            0,0,0,0,0,0,0,0,0,
            0,0,0,0,0,0,0,0,0,
            0,0,0,0,0,0,0,0,0,
            0,0,0,0,0,0,0,0,0,
            0,0,0,0,0,0,0,0,0,
            0,0,0,0,0,0,0,0,0
        ],
        "dropItems": [
            0,0,0,0,0,0,0,0,0,
            0,0,0,0,0,0,0,0,0,
            0,0,0,0,0,0,0,0,0,
            0,0,0,0,0,0,0,0,0,
            0,0,0,0,0,0,0,0,0,
            0,0,0,0,0,0,0,0,0,
            0,0,0,0,0,0,0,0,0,
            0,0,0,0,0,0,0,0,0,
            0,0,0,0,0,0,0,0,0
        ],
        "chains": [
            0,0,0,0,0,0,0,0,0,
            0,0,0,0,0,0,0,0,0,
            0,0,0,0,0,0,0,0,0,
            0,0,0,0,0,0,0,0,0,
            0,0,0,0,0,0,0,0,0,
            0,0,0,0,0,0,0,0,0,
            0,0,0,0,0,0,0,0,0,
            0,0,0,0,0,0,0,0,0,
            0,0,0,0,0,0,0,0,0
        ],
        "hiddenItems": [
            0,0,0,0,0,0,0,5,5,
            0,0,0,0,0,0,0,5,5,
            0,0,8,8,0,0,0,0,0,
            0,0,8,8,0,0,1,1,1,
            0,0,0,0,0,0,1,1,1,
            0,0,0,0,0,0,1,1,1,
            0,0,7,7,0,0,0,0,0,
            0,0,7,7,0,0,0,6,6,
            0,0,0,0,0,0,0,6,6
        ],
        "gemColors": [
            6,6,0,0,0,8,8,8,8,
            6,6,6,6,0,8,8,8,8,
            3,6,6,6,6,8,0,8,8,
            3,6,6,6,6,8,8,8,8,
            3,6,6,6,6,8,8,8,8,
            3,6,6,6,6,8,8,8,8,
            3,6,6,6,6,8,0,8,8,
            3,6,6,6,0,8,8,8,8,
            12,6,0,0,0,8,8,8,8
        ],
        "gemTypes": [
            0,0,0,0,0,0,0,0,0,
            0,0,0,0,0,0,6,0,0,
            0,0,0,0,0,0,0,0,0,
            0,0,0,0,0,0,0,0,0,
            0,0,0,0,0,0,6,0,0,
            0,0,0,0,0,0,0,0,0,
            0,0,0,0,0,0,0,0,0,
            0,0,0,0,0,0,6,0,0,
            0,0,0,0,0,0,0,0,0
        ],
        "gemModifier": [
            0,0,0,0,0,0,0,0,0,
            0,0,0,0,0,0,0,0,0,
            0,0,0,0,0,0,0,0,0,
            0,0,0,0,0,0,0,0,0,
            0,0,0,0,0,0,0,0,0,
            0,0,0,0,0,0,0,0,0,
            0,0,0,0,0,0,0,0,0,
            0,0,0,0,0,0,0,0,0,
            0,0,0,0,0,0,0,0,0
        ],
        "portals": [
            0,0,0,0,0,0,0,0,0,
            0,0,0,0,0,0,0,0,0,
            0,0,0,0,0,0,0,0,0,
            0,0,0,0,0,0,0,0,0,
            0,0,0,0,0,0,0,0,0,
            0,0,0,0,0,0,0,0,0,
            0,0,0,0,0,0,0,0,0,
            0,0,0,0,0,0,0,0,0,
            0,0,0,0,0,0,0,0,0
        ],
        "crates": [
            14,14,0,0,0,0,0,0,0,
            14,14,25,26,0,0,0,0,0,
            14,14,25,26,14,0,0,0,0,
            14,14,25,26,13,0,0,0,0,
            14,14,25,26,14,0,0,0,0,
            14,14,25,26,13,0,0,0,0,
            14,14,25,26,14,0,0,0,0,
            14,14,25,26,0,0,0,0,0,
            0,14,0,0,0,0,0,0,0
        ],
        "climbers": [
            2,2,0,0,0,0,0,0,0,
            0,0,2,2,0,0,0,0,0,
            0,0,0,0,2,0,0,0,0,
            0,0,0,0,0,0,0,0,0,
            0,0,0,0,0,0,0,0,0,
            0,0,0,0,0,0,0,0,0,
            0,0,0,0,0,0,0,0,0,
            0,0,0,0,0,0,0,0,0,
            0,1,0,0,0,0,0,0,0
        ]
    },
    "collectable": ""
}
