{
    "data": {
        "moves": 29,
        "gems": [
            {
                "type": "red",
                "amount": 25
            },
            {
                "type": "purple",
                "amount": 25
            },
            {
                "type": "green",
                "amount": 25
            },
            {
                "type": "blue",
                "amount": 25
            },
            {
                "type": "coins",
                "amount": 25
            },
            {
                "type": "orange",
                "amount": 4
            }
        ],
        "objectives": [
            {
                "type": "blue",
                "amount": 260
            }
        ],
        "spawnRatioDroppable": {
            "gemColor": 0,
            "gemType": 0,
            "minSpawn": 0,
            "maxSpawn": 0,
            "probability": 0
        },
        "spawnRatios": [
            
        ],
        "hiddenItemName": "monkey"
    },
    "layout": {
        "fields": [
            0,0,1,1,1,1,1,1,1,
            0,0,0,1,1,1,1,1,1,
            1,1,0,0,1,1,1,1,1,
            1,1,1,0,0,1,1,1,1,
            0,1,1,1,0,0,1,1,1,
            0,0,1,1,1,0,0,1,1,
            1,0,0,1,1,1,0,0,1,
            1,1,0,0,1,1,1,0,0,
            1,1,1,0,0,1,1,1,0
        ],
        "tiles": [
            0,0,0,0,0,0,0,0,0,
            0,0,0,0,0,0,0,0,0,
            0,3,0,0,0,0,0,0,0,
            3,0,3,0,0,0,0,0,0,
            0,3,0,0,0,0,0,0,0,
            0,0,0,0,0,0,0,0,0,
            0,0,0,0,0,0,0,0,0,
            0,0,0,0,0,0,0,0,0,
            0,0,0,0,0,0,0,0,0
        ],
        "stones": [
            0,0,0,0,0,0,0,0,0,
            0,0,0,0,0,0,0,0,0,
            0,0,0,0,0,0,0,0,0,
            0,0,0,0,0,0,0,0,0,
            0,0,0,0,0,0,0,0,0,
            0,0,0,0,0,0,0,0,0,
            0,0,0,0,0,0,0,0,0,
            0,0,0,0,0,0,0,0,0,
            0,0,0,0,0,0,0,0,0
        ],
        "spawning": [
            0,0,1,1,1,1,1,1,1,
            0,0,0,0,0,0,0,0,0,
            2,1,0,0,0,0,0,0,0,
            0,2,1,0,0,0,0,0,0,
            0,0,2,1,0,0,0,0,0,
            0,0,0,2,1,0,0,0,0,
            0,0,0,0,2,1,0,0,0,
            0,0,0,0,0,2,1,0,0,
            0,0,0,0,0,0,2,1,0
        ],
        "dropItems": [
            0,0,0,0,0,0,0,0,0,
            0,0,0,0,0,0,0,0,0,
            0,0,0,0,0,0,0,0,0,
            0,0,0,0,0,0,0,0,0,
            0,0,0,0,0,0,0,0,0,
            0,0,0,0,0,0,0,0,0,
            0,0,0,0,0,0,0,0,0,
            0,0,0,0,0,0,0,0,0,
            0,0,0,0,0,0,0,0,0
        ],
        "chains": [
            0,0,0,0,0,0,0,0,0,
            0,0,0,0,0,0,0,0,0,
            0,0,0,0,0,0,0,0,0,
            0,0,0,0,0,0,0,0,0,
            0,0,0,0,0,0,0,0,0,
            0,0,0,0,0,0,0,0,0,
            0,0,0,0,0,0,0,0,0,
            0,0,0,0,0,0,0,0,0,
            0,0,0,0,0,0,0,0,0
        ],
        "hiddenItems": [
            0,0,0,0,0,0,0,0,0,
            0,0,0,0,0,0,0,0,0,
            0,0,0,0,0,0,0,0,0,
            0,0,0,0,0,0,0,0,0,
            0,0,0,0,0,0,0,0,0,
            0,0,0,0,0,0,0,0,0,
            0,0,0,0,0,0,0,0,0,
            0,0,0,0,0,0,0,0,0,
            0,0,0,0,0,0,0,0,0
        ],
        "gemColors": [
            0,0,10,8,8,8,8,8,8,
            0,0,0,10,8,8,8,8,8,
            3,10,0,0,10,8,8,8,8,
            10,3,10,0,0,10,10,10,10,
            0,10,3,1,0,0,10,10,10,
            0,0,5,3,5,0,0,10,10,
            10,0,0,1,3,1,0,0,10,
            10,10,0,0,5,3,5,0,0,
            10,10,10,0,0,1,3,1,0
        ],
        "gemTypes": [
            0,0,0,0,0,0,0,0,0,
            0,0,0,0,0,0,0,0,0,
            7,0,0,0,0,0,0,0,0,
            0,7,0,0,0,0,0,0,0,
            0,0,7,10,0,0,0,0,0,
            0,0,10,7,10,0,0,0,0,
            0,0,0,10,7,10,0,0,0,
            0,0,0,0,10,7,10,0,0,
            0,0,0,0,0,10,7,10,0
        ],
        "gemModifier": [
            0,0,0,0,0,0,0,0,0,
            0,0,0,0,0,0,0,0,0,
            0,0,0,0,0,0,0,0,0,
            0,0,0,0,0,0,0,0,0,
            0,0,0,7,0,0,0,0,0,
            0,0,7,0,8,0,0,0,0,
            0,0,0,8,0,7,0,0,0,
            0,0,0,0,7,0,7,0,0,
            0,0,0,0,0,7,0,7,0
        ],
        "portals": [
            0,0,1,0,0,0,0,0,0,
            0,0,0,0,0,0,0,0,0,
            0,0,0,0,0,0,0,0,0,
            0,0,0,0,0,3,0,0,0,
            0,0,0,0,0,0,0,0,0,
            0,0,0,0,0,0,0,0,0,
            2,0,0,0,0,0,0,0,5,
            0,4,0,0,0,0,0,0,0,
            0,0,6,0,0,0,0,0,0
        ],
        "crates": [
            0,0,0,0,0,0,0,0,0,
            0,0,0,0,0,0,0,0,0,
            0,0,0,0,0,0,0,0,0,
            0,0,0,0,0,0,0,0,0,
            0,0,0,0,0,0,0,0,0,
            0,0,0,0,0,0,0,0,0,
            0,0,0,0,0,0,0,0,0,
            0,0,0,0,0,0,0,0,0,
            0,0,0,0,0,0,0,0,0
        ],
        "climbers": [
            0,0,0,0,0,0,0,0,0,
            0,0,0,0,0,0,0,0,0,
            0,0,0,0,0,0,0,0,0,
            0,0,0,0,0,0,0,0,0,
            0,0,0,0,0,0,0,0,0,
            0,0,0,0,0,0,0,0,0,
            0,0,0,0,0,0,0,0,0,
            0,0,0,0,0,0,0,0,0,
            0,0,0,0,0,0,0,0,0
        ]
    },
    "collectable": ""
}
