{
    "data": {
        "moves": 35,
        "gems": [
            {
                "type": "coins",
                "amount": 25
            },
            {
                "type": "orange",
                "amount": 25
            },
            {
                "type": "blue",
                "amount": 25
            },
            {
                "type": "red",
                "amount": 25
            },
            {
                "type": "green",
                "amount": 25
            }
        ],
        "objectives": [
            {
                "type": "coins",
                "amount": 120
            }
        ],
        "spawnRatioDroppable": {
            "gemColor": 0,
            "gemType": 0,
            "minSpawn": 0,
            "maxSpawn": 0,
            "probability": 0
        },
        "spawnRatios": [
            
        ],
        "hiddenItemName": "monkey"
    },
    "layout": {
        "fields": [
            1,1,1,1,1,1,1,1,1,
            1,1,1,1,1,1,1,1,1,
            1,1,1,0,1,1,1,1,1,
            1,1,1,1,1,1,1,1,1,
            1,1,1,0,1,1,1,1,1,
            1,1,1,1,1,1,1,1,1,
            1,1,1,0,1,1,1,1,1,
            1,1,1,1,1,1,1,1,1,
            1,1,1,1,1,1,1,1,1
        ],
        "tiles": [
            0,0,0,0,0,0,0,0,0,
            0,0,0,0,0,0,0,0,0,
            0,0,0,0,0,0,0,0,0,
            0,0,0,0,0,0,0,0,0,
            0,0,0,0,0,0,0,0,0,
            0,0,0,0,0,0,0,0,0,
            0,0,0,0,0,0,0,0,0,
            0,0,0,0,0,0,0,0,0,
            0,0,0,0,0,0,0,0,0
        ],
        "stones": [
            0,0,0,0,0,0,0,0,0,
            0,0,0,0,0,0,0,0,0,
            0,0,0,0,0,0,0,0,0,
            0,0,0,0,0,0,0,8,8,
            0,0,0,0,0,0,0,8,0,
            0,0,0,0,0,0,0,8,8,
            0,0,0,0,0,0,0,0,0,
            0,0,0,0,0,0,0,0,0,
            0,0,0,0,0,0,0,0,0
        ],
        "spawning": [
            1,1,1,1,1,1,1,1,1,
            0,0,0,0,0,0,0,0,0,
            0,0,0,0,0,0,0,0,0,
            0,0,0,0,0,0,0,0,0,
            0,0,0,0,0,0,0,0,0,
            0,0,0,0,0,0,0,0,0,
            0,0,0,0,0,0,0,0,0,
            0,0,0,0,0,0,0,0,0,
            0,0,0,0,0,0,0,0,0
        ],
        "dropItems": [
            0,0,0,0,0,0,0,0,0,
            0,0,0,0,0,0,0,0,0,
            0,0,0,0,0,0,0,0,0,
            0,0,0,0,0,0,0,0,0,
            0,0,0,0,0,0,0,0,0,
            0,0,0,0,0,0,0,0,0,
            0,0,0,0,0,0,0,0,0,
            0,0,0,0,0,0,0,0,0,
            0,0,0,0,0,0,0,0,0
        ],
        "chains": [
            0,0,0,0,2,0,0,0,0,
            0,0,0,0,1,0,0,0,0,
            0,0,0,0,1,0,0,0,0,
            0,0,0,0,1,0,0,0,0,
            0,0,0,0,1,0,0,0,0,
            0,0,0,0,1,0,0,0,0,
            0,0,0,0,1,0,0,0,0,
            0,0,0,0,1,0,0,0,0,
            0,0,0,0,2,0,0,0,0
        ],
        "hiddenItems": [
            0,0,0,0,0,0,0,0,0,
            0,0,0,0,0,0,0,0,0,
            0,0,0,0,0,0,0,0,0,
            0,0,0,0,0,0,0,0,0,
            0,0,0,0,0,0,0,0,0,
            0,0,0,0,0,0,0,0,0,
            0,0,0,0,0,0,0,0,0,
            0,0,0,0,0,0,0,0,0,
            0,0,0,0,0,0,0,0,0
        ],
        "gemColors": [
            8,8,8,8,8,8,9,8,9,
            8,8,8,8,8,10,10,10,10,
            8,8,8,0,8,10,8,8,8,
            8,8,8,8,8,10,8,0,0,
            8,8,8,0,8,10,8,0,9,
            8,8,8,8,8,10,8,0,0,
            8,8,8,0,8,10,8,8,8,
            8,8,8,8,8,10,10,10,10,
            8,8,8,8,8,8,9,8,9
        ],
        "gemTypes": [
            0,0,0,0,0,0,8,0,8,
            0,0,0,0,0,0,0,0,0,
            0,0,0,0,0,0,3,0,2,
            0,0,0,0,0,0,0,0,0,
            0,0,0,0,0,0,3,0,9,
            0,0,0,0,0,0,0,0,0,
            0,0,0,0,0,0,3,0,2,
            0,0,0,0,0,0,0,0,0,
            0,0,0,0,0,0,8,0,8
        ],
        "gemModifier": [
            0,0,0,0,0,0,2,0,2,
            0,0,0,0,0,0,0,0,0,
            0,0,0,0,0,0,0,0,0,
            0,0,0,0,0,0,0,0,0,
            0,0,0,0,0,0,0,0,3,
            0,0,0,0,0,0,0,0,0,
            0,0,0,0,0,0,0,0,0,
            0,0,0,0,0,0,0,0,0,
            0,0,0,0,0,0,2,0,2
        ],
        "portals": [
            0,0,0,0,0,0,0,0,0,
            0,0,0,0,0,0,0,0,0,
            0,0,0,0,0,0,0,0,0,
            0,0,0,0,0,0,0,0,0,
            0,0,0,0,0,0,0,0,0,
            0,0,0,0,0,0,0,0,0,
            0,0,0,0,0,0,0,0,0,
            0,0,0,0,0,0,0,0,0,
            0,0,0,0,0,0,0,0,0
        ],
        "crates": [
            0,0,0,0,0,1,0,1,0,
            0,0,0,0,0,0,0,0,0,
            0,0,0,0,0,0,1,2,1,
            0,0,0,0,0,0,3,0,0,
            0,0,0,0,0,0,1,0,0,
            0,0,0,0,0,0,3,0,0,
            0,0,0,0,0,0,1,2,1,
            0,0,0,0,0,0,0,0,0,
            0,0,0,0,0,1,0,1,0
        ],
        "climbers": [
            0,0,0,0,0,0,0,0,0,
            0,0,0,0,0,0,0,0,0,
            0,0,0,0,0,0,0,0,0,
            0,0,0,0,0,0,0,0,0,
            0,0,0,0,0,0,0,0,0,
            0,0,0,0,0,0,0,0,0,
            0,0,0,0,0,0,0,0,0,
            0,0,0,0,0,0,0,0,0,
            0,0,0,0,0,0,0,0,0
        ]
    },
    "collectable": ""
}
