{
    "data": {
        "moves": 40,
        "gems": [
            {
                "type": "coins",
                "amount": 25
            },
            {
                "type": "purple",
                "amount": 25
            },
            {
                "type": "red",
                "amount": 25
            },
            {
                "type": "blue",
                "amount": 25
            },
            {
                "type": "green",
                "amount": 25
            }
        ],
        "objectives": [
            {
                "type": "climber",
                "amount": 5
            }
        ],
        "spawnRatioDroppable": {
            "gemColor": 0,
            "gemType": 0,
            "minSpawn": 0,
            "maxSpawn": 0,
            "probability": 0
        },
        "spawnRatios": [
            
        ],
        "hiddenItemName": "monkey"
    },
    "layout": {
        "fields": [
            0,1,1,1,0,1,1,1,1,
            0,1,1,1,0,1,1,1,1,
            1,1,1,1,1,1,1,1,1,
            1,1,1,1,0,1,1,1,1,
            0,1,1,1,0,1,1,1,1,
            1,1,1,1,0,1,1,1,1,
            1,1,1,1,1,1,1,1,1,
            1,1,1,1,1,1,1,1,1,
            1,1,1,1,1,1,1,1,1
        ],
        "tiles": [
            0,0,0,0,0,0,0,0,0,
            0,0,0,0,0,0,0,0,0,
            0,0,0,0,0,0,0,0,0,
            0,0,0,0,0,3,0,3,0,
            0,0,0,0,0,0,0,0,0,
            0,0,0,0,0,3,0,3,0,
            0,0,0,0,0,0,0,0,0,
            0,0,0,0,0,0,0,0,0,
            0,0,0,0,0,0,0,0,0
        ],
        "stones": [
            0,0,0,0,0,0,0,0,0,
            0,0,0,0,0,0,0,0,0,
            0,0,0,0,0,0,0,0,0,
            0,0,0,0,0,0,0,0,0,
            0,0,0,0,0,0,0,0,0,
            0,0,0,0,0,0,0,0,0,
            0,0,0,0,0,0,0,0,0,
            0,0,0,9,10,0,0,0,0,
            0,0,0,10,10,0,0,0,0
        ],
        "spawning": [
            0,1,1,1,0,0,0,0,0,
            0,0,0,0,0,0,0,0,0,
            0,0,0,0,0,0,0,0,0,
            0,0,0,0,0,0,0,0,0,
            0,0,0,0,0,2,2,2,2,
            0,0,0,0,0,1,1,1,1,
            0,0,0,0,0,0,0,0,0,
            0,0,0,0,0,0,0,0,0,
            0,0,0,0,0,0,0,0,0
        ],
        "dropItems": [
            0,0,0,0,0,0,0,0,0,
            0,0,0,0,0,0,0,0,0,
            0,0,0,0,0,0,0,0,0,
            0,0,0,0,0,0,0,0,0,
            0,0,0,0,0,0,0,0,0,
            0,0,0,0,0,0,0,0,0,
            0,0,0,0,0,0,0,0,0,
            0,0,0,0,0,0,0,0,0,
            0,0,0,0,0,0,0,0,0
        ],
        "chains": [
            0,0,0,0,0,0,0,0,0,
            0,0,0,0,0,0,0,0,0,
            0,0,0,0,0,0,0,0,0,
            0,0,0,0,0,0,0,0,0,
            0,0,0,0,0,0,0,0,0,
            0,0,0,0,0,0,0,0,0,
            0,0,0,0,0,0,0,0,0,
            0,0,0,0,0,0,0,0,0,
            0,0,0,0,0,0,0,0,0
        ],
        "hiddenItems": [
            0,0,0,0,0,0,0,0,0,
            0,0,0,0,0,0,0,0,0,
            0,0,0,0,0,0,0,0,0,
            0,0,0,0,0,0,0,0,0,
            0,0,0,0,0,0,0,0,0,
            0,0,0,0,0,0,0,0,0,
            0,0,0,0,0,0,0,0,0,
            0,0,0,0,0,0,0,0,0,
            0,0,0,0,0,0,0,0,0
        ],
        "gemColors": [
            0,8,8,8,0,8,8,8,8,
            0,8,8,8,0,8,8,8,8,
            8,8,8,8,8,8,8,8,8,
            8,8,8,8,0,8,8,8,12,
            0,8,8,8,0,8,8,8,8,
            8,8,8,8,0,8,8,8,8,
            8,8,8,8,8,8,8,8,8,
            8,8,8,0,0,8,8,8,8,
            8,8,8,0,0,8,8,8,8
        ],
        "gemTypes": [
            0,0,0,0,0,6,0,0,6,
            0,0,0,0,0,0,0,6,0,
            0,0,0,0,0,0,6,0,6,
            0,0,0,0,0,0,0,0,0,
            0,0,0,0,0,6,6,6,6,
            0,0,0,0,0,0,0,0,0,
            0,0,0,6,0,0,6,0,6,
            0,0,6,0,0,6,0,6,0,
            0,0,0,0,0,0,6,0,6
        ],
        "gemModifier": [
            0,0,0,0,0,0,0,0,0,
            0,0,0,0,0,0,0,0,0,
            0,0,0,0,0,0,0,0,0,
            0,0,0,0,0,0,0,0,0,
            0,0,0,0,0,0,0,0,0,
            0,0,0,0,0,0,0,0,0,
            0,0,0,0,0,0,0,0,0,
            0,0,0,0,0,0,0,0,0,
            0,0,0,0,0,0,0,0,0
        ],
        "portals": [
            0,0,0,0,0,2,4,6,8,
            0,0,0,0,0,0,0,0,0,
            0,0,0,0,0,0,0,0,0,
            0,0,0,0,0,0,0,0,0,
            0,0,0,0,0,0,0,0,0,
            0,0,0,0,0,0,0,0,0,
            0,0,0,0,0,0,0,0,0,
            0,0,0,0,0,0,0,0,0,
            0,0,0,0,0,1,3,5,7
        ],
        "crates": [
            0,0,0,0,0,3,3,3,3,
            0,0,0,0,0,3,3,3,3,
            0,0,0,0,1,1,1,1,1,
            0,0,0,0,0,0,0,0,0,
            0,0,0,0,0,2,1,2,1,
            0,0,0,0,0,0,0,0,0,
            0,0,1,1,1,1,1,1,1,
            0,0,1,0,0,3,3,3,3,
            0,0,1,0,0,3,3,3,3
        ],
        "climbers": [
            0,2,2,2,0,0,0,0,0,
            0,0,0,0,0,0,0,0,0,
            2,0,0,0,2,0,0,0,0,
            0,0,0,0,0,1,1,1,0,
            0,0,0,0,0,0,0,0,0,
            0,0,0,0,0,2,2,2,2,
            0,0,0,0,2,0,0,0,0,
            0,0,0,0,0,0,0,0,0,
            0,0,0,0,0,0,0,0,0
        ]
    },
    "collectable": ""
}
