{
    "data": {
        "moves": 33,
        "gems": [
            {
                "type": "coins",
                "amount": 25
            },
            {
                "type": "red",
                "amount": 25
            },
            {
                "type": "yellow",
                "amount": 25
            },
            {
                "type": "purple",
                "amount": 25
            },
            {
                "type": "green",
                "amount": 6
            }
        ],
        "objectives": [
            
        ],
        "spawnRatioDroppable": {
            "gemColor": 0,
            "gemType": 0,
            "minSpawn": 0,
            "maxSpawn": 0,
            "probability": 0
        },
        "spawnRatios": [
            {
                "gemColor": 8,
                "gemType": 1,
                "minSpawn": 0,
                "maxSpawn": 2,
                "probability": 2
            }
        ],
        "hiddenItemName": "monkey"
    },
    "layout": {
        "fields": [
            0,0,0,0,1,3,3,3,1,
            1,1,1,0,1,3,3,3,1,
            1,1,1,0,1,3,1,3,3,
            1,1,1,1,1,3,3,3,3,
            1,1,1,1,1,3,1,1,1,
            1,1,1,1,1,3,3,3,3,
            1,1,1,0,1,3,1,3,3,
            1,1,1,0,1,3,3,3,1,
            0,0,0,0,1,3,3,3,1
        ],
        "tiles": [
            0,0,0,0,0,0,0,0,0,
            0,0,0,0,0,0,0,0,0,
            0,0,0,0,0,0,0,0,0,
            0,0,0,0,0,0,0,0,0,
            0,0,0,0,0,0,0,0,0,
            0,0,0,0,0,0,0,0,0,
            0,0,0,0,0,0,0,0,0,
            0,0,0,0,0,0,0,0,0,
            0,0,0,0,0,0,0,0,0
        ],
        "stones": [
            0,0,0,0,0,0,0,0,0,
            0,0,0,0,8,0,0,0,8,
            0,0,0,0,8,0,0,0,0,
            0,0,0,0,8,0,0,0,0,
            0,0,0,0,8,0,8,8,0,
            0,0,0,0,8,0,0,0,0,
            0,0,0,0,8,0,0,0,0,
            0,0,0,0,8,0,0,0,8,
            0,0,0,0,0,0,0,0,0
        ],
        "spawning": [
            0,0,0,0,1,1,1,1,1,
            1,1,1,0,0,0,0,0,0,
            0,0,0,0,0,0,0,0,0,
            0,0,0,0,0,0,0,0,0,
            0,0,0,0,0,0,0,0,0,
            0,0,0,0,0,0,0,0,0,
            0,0,0,0,0,0,0,0,0,
            0,0,0,0,0,0,0,0,0,
            0,0,0,0,0,0,0,0,0
        ],
        "dropItems": [
            0,0,0,0,0,0,0,0,0,
            0,0,0,0,0,0,0,0,0,
            0,0,0,0,0,0,0,0,0,
            0,0,0,0,0,0,0,0,0,
            0,0,0,0,0,0,0,0,0,
            0,0,0,0,0,0,0,0,0,
            0,0,0,0,0,0,0,0,0,
            0,0,0,0,0,0,0,0,0,
            0,0,0,0,0,0,0,0,0
        ],
        "chains": [
            0,0,0,0,0,0,0,0,0,
            0,0,0,0,0,0,0,0,0,
            0,0,0,0,0,0,0,0,0,
            0,0,0,0,0,0,0,0,0,
            0,0,0,0,0,0,0,0,0,
            0,0,0,0,0,0,0,0,0,
            0,0,0,0,0,0,0,0,0,
            0,0,0,0,0,0,0,0,0,
            0,0,0,0,0,0,0,0,0
        ],
        "hiddenItems": [
            0,0,0,0,0,0,0,0,0,
            0,0,0,0,0,0,0,0,0,
            0,0,0,0,0,0,0,0,0,
            0,0,0,0,0,0,0,0,0,
            0,0,0,0,0,0,0,0,0,
            0,0,0,0,0,0,0,0,0,
            0,0,0,0,0,0,0,0,0,
            0,0,0,0,0,0,0,0,0,
            0,0,0,0,0,0,0,0,0
        ],
        "gemColors": [
            0,0,0,0,4,0,0,0,4,
            8,8,8,0,0,0,0,0,0,
            8,8,8,0,0,0,8,0,0,
            8,8,8,4,0,0,0,0,0,
            8,8,8,4,0,0,0,0,4,
            8,8,8,4,0,0,0,0,0,
            8,8,8,0,0,0,8,0,0,
            8,8,8,0,0,0,0,0,0,
            0,0,0,0,4,0,0,0,4
        ],
        "gemTypes": [
            0,0,0,0,10,0,0,0,10,
            0,0,0,0,0,0,0,0,0,
            0,0,0,0,0,0,0,0,0,
            0,0,0,10,0,0,0,0,0,
            0,0,0,7,0,0,0,0,7,
            0,0,0,10,0,0,0,0,0,
            0,0,0,0,0,0,0,0,0,
            0,0,0,0,0,0,0,0,0,
            0,0,0,0,8,0,0,0,8
        ],
        "gemModifier": [
            0,0,0,0,8,0,0,0,7,
            0,0,0,0,0,0,0,0,0,
            0,0,0,0,0,0,0,0,0,
            0,0,0,8,0,0,0,0,0,
            0,0,0,0,0,0,0,0,0,
            0,0,0,7,0,0,0,0,0,
            0,0,0,0,0,0,0,0,0,
            0,0,0,0,0,0,0,0,0,
            0,0,0,0,0,0,0,0,0
        ],
        "portals": [
            0,0,0,0,0,0,0,0,0,
            0,0,0,0,0,0,0,0,0,
            0,0,0,0,0,0,0,0,0,
            0,0,0,0,0,0,0,0,0,
            0,0,0,0,0,0,0,0,0,
            0,0,0,0,0,0,0,0,0,
            0,0,0,0,0,0,0,0,0,
            0,0,0,0,0,0,0,0,0,
            0,0,0,0,0,0,0,0,0
        ],
        "crates": [
            0,0,0,0,1,0,0,0,2,
            0,0,0,0,1,0,0,0,0,
            0,0,0,0,0,0,1,0,0,
            0,0,0,1,0,0,0,0,0,
            0,0,0,1,0,0,1,1,1,
            0,0,0,1,0,0,0,0,0,
            0,0,0,0,0,0,1,0,0,
            0,0,0,0,1,0,0,0,0,
            0,0,0,0,1,0,0,0,2
        ],
        "climbers": [
            0,0,0,0,0,0,0,0,0,
            0,0,0,0,0,0,0,0,0,
            0,0,0,0,0,0,0,0,0,
            0,0,0,0,0,0,0,0,0,
            0,0,0,0,0,0,0,0,0,
            0,0,0,0,0,0,0,0,0,
            0,0,0,0,0,0,0,0,0,
            0,0,0,0,0,0,0,0,0,
            0,0,0,0,0,0,0,0,0
        ]
    },
    "collectable": ""
}
