{
    "data": {
        "moves": 35,
        "gems": [
            {
                "type": "coins",
                "amount": 25
            },
            {
                "type": "red",
                "amount": 25
            },
            {
                "type": "blue",
                "amount": 25
            },
            {
                "type": "yellow",
                "amount": 25
            },
            {
                "type": "orange",
                "amount": 25
            },
            {
                "type": "green",
                "amount": 2
            }
        ],
        "objectives": [
            {
                "type": "blue",
                "amount": 200
            }
        ],
        "spawnRatioDroppable": {
            "gemColor": 0,
            "gemType": 0,
            "minSpawn": 0,
            "maxSpawn": 0,
            "probability": 0
        },
        "spawnRatios": [
            {
                "gemColor": 3,
                "gemType": 8,
                "minSpawn": 1,
                "maxSpawn": 2,
                "probability": 1
            }
        ],
        "hiddenItemName": "monkey"
    },
    "layout": {
        "fields": [
            1,1,1,1,1,1,1,0,0,
            1,1,1,1,1,1,1,0,1,
            1,1,0,0,1,1,1,1,1,
            1,1,1,1,1,1,1,1,1,
            0,1,1,1,1,1,1,1,0,
            1,1,1,1,1,1,1,1,1,
            1,1,1,1,1,0,0,1,1,
            1,0,1,1,1,1,1,1,1,
            0,0,1,1,1,1,1,1,1
        ],
        "tiles": [
            0,0,0,0,0,0,0,0,0,
            0,0,0,0,0,0,0,0,0,
            0,0,0,0,0,0,0,0,0,
            0,0,0,0,0,0,0,0,0,
            0,0,0,0,0,0,0,0,0,
            0,0,0,0,0,0,0,0,0,
            0,0,0,0,0,0,0,0,0,
            0,0,0,0,0,0,0,0,0,
            0,0,0,0,0,0,0,0,0
        ],
        "stones": [
            0,0,0,0,0,0,0,0,0,
            0,0,0,0,0,0,0,0,0,
            0,0,0,0,0,0,0,0,0,
            0,0,0,0,0,0,0,0,0,
            0,0,0,0,0,0,0,0,0,
            0,0,0,0,0,0,0,0,0,
            0,0,0,0,0,0,0,0,0,
            0,0,0,0,0,0,0,0,0,
            0,0,0,0,0,0,0,0,0
        ],
        "spawning": [
            1,1,1,1,1,1,1,0,0,
            0,0,0,0,0,0,0,0,1,
            0,0,0,0,0,0,0,0,0,
            0,0,0,0,0,0,0,0,0,
            0,0,0,0,0,0,0,0,0,
            0,0,0,0,0,0,0,0,0,
            0,0,0,0,0,0,0,0,0,
            0,0,0,0,0,0,0,0,0,
            0,0,0,0,0,0,0,0,0
        ],
        "dropItems": [
            0,0,0,0,0,0,0,0,0,
            0,0,0,0,0,0,0,0,0,
            0,0,0,0,0,0,0,0,0,
            0,0,0,0,0,0,0,0,0,
            0,0,0,0,0,0,0,0,0,
            0,0,0,0,0,0,0,0,0,
            0,0,0,0,0,0,0,0,0,
            0,0,0,0,0,0,0,0,0,
            0,0,0,0,0,0,0,0,0
        ],
        "chains": [
            2,0,0,0,0,0,0,0,0,
            0,2,0,0,0,0,0,0,0,
            0,0,0,0,0,0,0,0,0,
            0,0,0,0,1,0,0,0,0,
            0,0,0,0,0,0,0,0,0,
            0,0,0,0,0,0,0,0,0,
            0,0,0,0,1,0,0,0,0,
            0,0,0,0,0,0,0,2,0,
            0,0,0,0,0,0,0,0,2
        ],
        "hiddenItems": [
            0,0,0,0,0,0,0,0,0,
            0,0,0,0,0,0,0,0,0,
            0,0,0,0,0,0,0,0,0,
            0,0,0,0,0,0,0,0,0,
            0,0,0,0,0,0,0,0,0,
            0,0,0,0,0,0,0,0,0,
            0,0,0,0,0,0,0,0,0,
            0,0,0,0,0,0,0,0,0,
            0,0,0,0,0,0,0,0,0
        ],
        "gemColors": [
            3,8,8,8,8,8,8,0,0,
            8,3,3,8,8,8,8,0,3,
            8,8,0,0,8,8,8,3,3,
            3,8,8,8,3,8,8,8,8,
            0,8,0,0,0,0,0,8,0,
            8,8,0,0,0,0,0,8,3,
            3,8,8,8,3,0,0,8,3,
            3,0,0,0,0,0,8,3,8,
            0,0,0,0,0,0,0,8,3
        ],
        "gemTypes": [
            8,0,0,0,0,0,0,0,0,
            0,7,7,0,0,0,0,0,8,
            0,0,0,0,0,0,0,7,7,
            7,0,0,0,8,0,3,0,0,
            0,3,0,0,0,0,0,0,0,
            0,0,0,0,0,0,0,0,7,
            7,2,0,0,8,0,0,0,7,
            8,0,0,0,0,0,0,7,0,
            0,0,0,0,0,0,0,2,9
        ],
        "gemModifier": [
            0,0,0,0,0,0,0,0,0,
            0,0,0,0,0,0,0,0,0,
            0,0,0,0,0,0,0,0,0,
            0,0,0,0,0,0,0,0,0,
            0,0,0,0,0,0,0,0,0,
            0,0,0,0,0,0,0,0,0,
            0,0,0,0,0,0,0,0,0,
            0,0,0,0,0,0,0,0,0,
            0,0,0,0,0,0,0,0,0
        ],
        "portals": [
            0,0,0,0,0,0,0,0,0,
            0,0,0,0,0,0,0,0,0,
            0,0,0,0,0,0,0,0,0,
            0,0,0,0,0,0,0,0,0,
            0,0,0,0,0,0,0,0,0,
            0,0,0,0,0,0,0,0,0,
            0,0,0,0,0,0,0,0,0,
            0,0,0,0,0,0,0,0,0,
            0,0,0,0,0,0,0,0,0
        ],
        "crates": [
            0,3,0,0,0,0,0,0,0,
            3,0,1,0,0,0,0,0,0,
            3,2,0,0,0,0,0,2,3,
            3,2,1,1,0,1,1,2,3,
            0,2,0,0,0,0,0,2,0,
            3,2,0,0,0,0,0,2,3,
            3,2,1,1,0,0,0,2,3,
            0,0,0,0,0,0,1,0,3,
            0,0,0,0,0,0,0,3,0
        ],
        "climbers": [
            0,0,0,0,0,0,0,0,0,
            0,0,0,0,0,0,0,0,0,
            0,0,0,0,0,0,0,0,0,
            0,0,0,0,0,0,0,0,0,
            0,0,0,0,0,0,0,0,0,
            0,0,0,0,0,0,0,0,0,
            0,0,0,0,0,0,0,0,0,
            0,0,0,0,0,0,0,0,0,
            0,0,0,0,0,0,0,0,0
        ]
    },
    "collectable": ""
}
