{
    "data": {
        "moves": 34,
        "gems": [
            {
                "type": "coins",
                "amount": 25
            },
            {
                "type": "orange",
                "amount": 25
            },
            {
                "type": "purple",
                "amount": 25
            },
            {
                "type": "red",
                "amount": 25
            },
            {
                "type": "green",
                "amount": 18
            }
        ],
        "objectives": [
            {
                "type": "coins",
                "amount": 140
            }
        ],
        "spawnRatioDroppable": {
            "gemColor": 0,
            "gemType": 0,
            "minSpawn": 0,
            "maxSpawn": 0,
            "probability": 0
        },
        "spawnRatios": [
            
        ],
        "hiddenItemName": "monkey"
    },
    "layout": {
        "fields": [
            1,1,1,1,0,1,1,1,1,
            1,1,1,1,0,1,1,1,1,
            1,1,1,1,0,1,1,1,1,
            1,1,1,1,1,1,1,1,1,
            1,1,1,1,1,1,0,0,0,
            1,1,1,1,1,1,1,1,1,
            1,1,1,1,1,1,1,1,1,
            1,1,1,1,1,1,1,1,1,
            1,1,1,1,1,1,1,1,1
        ],
        "tiles": [
            1,1,1,2,0,1,1,1,2,
            1,1,2,1,0,1,1,2,1,
            1,2,1,1,0,1,2,1,1,
            2,1,1,1,0,2,1,1,1,
            0,0,0,0,0,0,0,0,0,
            0,0,0,0,0,1,1,1,2,
            2,2,2,0,0,1,1,2,1,
            2,2,2,0,0,1,2,1,1,
            2,2,2,0,0,2,1,1,1
        ],
        "stones": [
            0,0,0,0,0,0,0,0,0,
            0,0,0,0,0,0,0,0,0,
            0,0,0,0,0,0,0,0,0,
            0,0,0,0,0,0,0,0,0,
            0,0,0,0,0,0,0,0,0,
            0,0,0,0,0,0,0,0,0,
            0,0,0,0,0,0,0,0,0,
            0,0,0,0,0,0,0,0,0,
            0,0,0,0,0,0,0,0,0
        ],
        "spawning": [
            1,1,1,1,0,1,1,1,1,
            0,0,0,0,0,0,0,0,0,
            0,0,0,0,0,0,0,0,0,
            0,0,0,0,1,0,0,0,0,
            0,0,0,0,0,0,0,0,0,
            0,0,0,0,0,0,1,1,1,
            0,0,0,0,0,0,0,0,0,
            0,0,0,0,0,0,0,0,0,
            0,0,0,0,0,0,0,0,0
        ],
        "dropItems": [
            0,0,0,0,0,0,0,0,0,
            0,0,0,0,0,0,0,0,0,
            0,0,0,0,0,0,0,0,0,
            0,0,0,0,0,0,0,0,0,
            0,0,0,0,0,0,0,0,0,
            0,0,0,0,0,0,0,0,0,
            0,0,0,0,0,0,0,0,0,
            0,0,0,0,0,0,0,0,0,
            0,0,0,0,0,0,0,0,0
        ],
        "chains": [
            0,0,0,0,0,0,0,0,0,
            0,0,0,0,0,0,0,0,0,
            0,0,0,0,0,0,0,0,0,
            0,0,0,0,0,0,0,0,0,
            0,0,0,0,0,0,0,0,0,
            0,0,0,0,0,0,0,0,0,
            0,0,0,0,0,0,0,0,0,
            0,0,0,0,0,0,0,0,0,
            0,0,0,0,0,0,0,0,0
        ],
        "hiddenItems": [
            6,6,6,0,0,5,5,5,0,
            6,6,6,0,0,5,5,5,0,
            6,6,6,0,0,5,5,5,0,
            0,0,0,0,0,0,0,0,0,
            0,0,0,0,0,0,0,0,0,
            0,0,0,0,0,0,7,7,7,
            1,1,1,0,0,0,7,7,7,
            1,1,1,0,0,0,7,7,7,
            1,1,1,0,0,0,0,0,0
        ],
        "gemColors": [
            9,8,8,8,0,9,8,8,8,
            8,9,8,8,0,8,9,8,8,
            8,8,8,9,0,8,8,9,8,
            8,8,8,8,8,8,8,8,9,
            8,8,8,9,8,8,0,0,0,
            8,8,8,8,9,8,9,8,8,
            8,8,8,8,8,8,8,8,8,
            8,9,8,8,8,8,8,9,8,
            8,8,8,8,8,8,8,8,9
        ],
        "gemTypes": [
            7,0,0,0,0,7,0,0,0,
            0,7,0,0,0,0,7,0,0,
            0,0,0,7,0,0,0,7,0,
            0,0,0,0,0,0,0,0,7,
            0,0,0,7,0,0,0,0,0,
            0,0,0,0,7,0,7,0,0,
            0,0,0,0,0,0,0,0,0,
            0,7,0,0,0,0,0,7,0,
            0,0,0,0,0,0,0,0,7
        ],
        "gemModifier": [
            0,0,0,0,0,0,0,0,0,
            0,0,0,0,0,0,0,0,0,
            0,0,0,0,0,0,0,0,0,
            0,0,0,0,0,0,0,0,0,
            0,0,0,0,0,0,0,0,0,
            0,0,0,0,0,0,0,0,0,
            0,0,0,0,0,0,0,0,0,
            0,0,0,0,0,0,0,0,0,
            0,0,0,0,0,0,0,0,0
        ],
        "portals": [
            0,0,0,0,0,0,0,0,0,
            0,0,0,0,0,0,0,0,0,
            0,0,0,0,0,0,0,0,0,
            0,0,0,0,0,0,0,0,0,
            0,0,0,0,0,0,0,0,0,
            0,0,0,0,0,0,0,0,0,
            0,0,0,0,0,0,0,0,0,
            0,0,0,0,0,0,0,0,0,
            0,0,0,0,0,0,0,0,0
        ],
        "crates": [
            2,1,2,0,0,1,1,2,0,
            1,3,0,2,0,1,3,0,2,
            2,0,2,1,0,2,0,3,1,
            0,2,1,1,2,0,2,1,1,
            0,1,1,3,0,2,0,0,0,
            0,0,2,0,3,1,1,2,0,
            0,0,0,2,1,1,2,0,2,
            0,0,0,0,1,2,0,3,1,
            0,0,0,0,0,0,2,1,2
        ],
        "climbers": [
            0,0,0,0,0,0,0,0,0,
            0,0,0,0,0,0,0,0,0,
            0,0,0,0,0,0,0,0,0,
            0,0,0,0,0,0,0,0,0,
            0,0,0,0,0,0,0,0,0,
            0,0,0,0,0,0,0,0,0,
            0,0,0,0,0,0,0,0,0,
            0,0,0,0,0,0,0,0,0,
            0,0,0,0,0,0,0,0,0
        ]
    },
    "collectable": ""
}
