{
    "data": {
        "moves": 29,
        "gems": [
            {
                "type": "coins",
                "amount": 25
            },
            {
                "type": "green",
                "amount": 25
            },
            {
                "type": "red",
                "amount": 25
            },
            {
                "type": "purple",
                "amount": 25
            },
            {
                "type": "yellow",
                "amount": 4
            }
        ],
        "objectives": [
            {
                "type": "climber",
                "amount": 3
            }
        ],
        "spawnRatioDroppable": {
            "gemColor": 0,
            "gemType": 0,
            "minSpawn": 0,
            "maxSpawn": 0,
            "probability": 0
        },
        "spawnRatios": [
            {
                "gemColor": 8,
                "gemType": 6,
                "minSpawn": 2,
                "maxSpawn": 7,
                "probability": 4
            }
        ],
        "hiddenItemName": "monkey"
    },
    "layout": {
        "fields": [
            1,0,0,1,1,0,0,0,1,
            1,1,0,1,1,1,0,1,0,
            1,1,1,1,1,1,1,0,0,
            1,1,1,1,1,1,1,1,0,
            1,1,2,1,1,1,1,1,1,
            1,1,1,2,1,1,1,1,1,
            1,1,1,1,2,1,1,0,0,
            1,1,1,1,1,1,1,1,0,
            1,1,1,1,1,1,1,1,1
        ],
        "tiles": [
            0,0,0,0,0,0,0,0,0,
            0,0,0,0,0,0,0,0,0,
            0,0,0,0,0,0,0,0,0,
            0,0,0,0,0,0,0,0,0,
            0,0,0,0,0,0,0,0,0,
            0,0,0,0,0,0,0,0,0,
            0,0,0,0,0,0,0,0,0,
            0,0,0,0,0,0,0,0,0,
            0,0,0,0,0,0,0,0,0
        ],
        "stones": [
            0,0,0,0,0,0,0,0,0,
            0,0,0,0,0,0,0,0,0,
            0,0,0,0,0,0,0,0,0,
            0,0,0,0,0,0,0,0,0,
            0,0,0,0,0,0,0,0,0,
            0,0,0,0,0,0,0,0,0,
            0,0,0,0,0,0,0,0,0,
            0,0,0,0,0,0,0,0,0,
            0,0,0,0,0,0,0,0,0
        ],
        "spawning": [
            1,0,0,1,1,0,0,0,1,
            0,1,0,0,0,1,0,1,0,
            0,0,1,0,0,0,1,0,0,
            0,0,0,0,0,0,0,1,0,
            0,0,0,0,0,0,0,0,1,
            0,0,0,0,0,0,0,0,0,
            0,0,0,0,0,0,0,0,0,
            0,0,0,0,0,0,0,1,0,
            0,0,0,0,0,0,0,0,1
        ],
        "dropItems": [
            0,0,0,0,0,0,0,0,0,
            0,0,0,0,0,0,0,0,0,
            0,0,0,0,0,0,0,0,0,
            0,0,0,0,0,0,0,0,0,
            0,0,0,0,0,0,0,0,0,
            0,0,0,0,0,0,0,0,0,
            0,0,0,0,0,0,0,0,0,
            0,0,0,0,0,0,0,0,0,
            0,0,0,0,0,0,0,0,0
        ],
        "chains": [
            0,0,0,0,0,0,0,0,0,
            0,0,0,0,0,0,0,0,0,
            0,0,0,0,0,0,0,0,0,
            0,0,0,0,0,0,0,0,0,
            0,0,0,0,0,0,0,0,0,
            0,0,0,0,0,0,0,0,0,
            0,0,0,0,0,0,0,0,0,
            0,0,0,0,0,0,0,0,0,
            0,0,0,0,0,0,0,0,0
        ],
        "hiddenItems": [
            0,0,0,0,0,0,0,0,0,
            0,0,0,0,0,0,0,0,0,
            0,0,0,0,0,0,0,0,0,
            0,0,0,0,0,0,0,0,0,
            0,0,0,0,0,0,0,0,0,
            0,0,0,0,0,0,0,0,0,
            0,0,0,0,0,0,0,0,0,
            0,0,0,0,0,0,0,0,0,
            0,0,0,0,0,0,0,0,0
        ],
        "gemColors": [
            8,0,0,8,8,0,0,0,9,
            0,8,0,0,0,8,0,2,0,
            0,0,8,0,0,0,9,0,0,
            0,8,8,8,0,0,0,8,0,
            8,8,0,8,8,0,0,0,8,
            8,8,9,0,8,8,9,0,8,
            8,8,8,9,0,8,8,0,0,
            8,8,8,8,9,8,8,9,0,
            8,12,8,8,8,8,8,8,8
        ],
        "gemTypes": [
            6,0,0,6,6,0,0,0,10,
            0,6,0,0,0,6,0,10,0,
            0,0,0,0,0,0,6,0,0,
            0,0,6,0,0,0,0,6,0,
            0,0,0,6,0,0,0,0,6,
            0,0,6,0,6,0,10,0,6,
            0,0,0,7,0,0,0,0,0,
            0,0,0,0,6,0,0,6,0,
            0,0,0,0,0,0,0,0,6
        ],
        "gemModifier": [
            0,0,0,0,0,0,0,0,9,
            0,0,0,0,0,0,0,8,0,
            0,0,0,0,0,0,0,0,0,
            0,0,0,0,0,0,0,0,0,
            0,0,0,0,0,0,0,0,0,
            0,0,0,0,0,0,7,0,0,
            0,0,0,0,0,0,0,0,0,
            0,0,0,0,0,0,0,0,0,
            0,0,0,0,0,0,0,0,0
        ],
        "portals": [
            0,0,0,0,0,0,0,0,0,
            0,0,0,0,0,0,0,0,0,
            0,0,0,0,0,0,0,0,0,
            0,0,0,0,0,0,0,0,0,
            0,0,0,0,0,0,0,0,0,
            0,0,0,0,0,0,0,0,0,
            0,0,0,0,0,0,0,0,0,
            0,0,0,0,0,0,0,0,0,
            0,0,0,0,0,0,0,0,0
        ],
        "crates": [
            39,0,0,11,39,0,0,0,0,
            0,11,0,0,0,11,0,0,0,
            0,0,0,0,0,0,39,0,0,
            0,0,11,0,0,0,0,11,0,
            0,0,0,39,0,0,0,0,39,
            0,0,38,0,11,0,0,0,11,
            0,0,0,10,0,0,0,0,0,
            0,0,0,0,38,0,0,11,0,
            0,0,0,0,0,0,0,0,39
        ],
        "climbers": [
            2,0,0,2,2,0,0,0,0,
            0,2,0,0,0,2,0,0,0,
            0,0,2,0,0,0,2,0,0,
            0,0,0,0,0,0,0,0,0,
            0,0,0,0,0,0,0,0,0,
            0,0,0,0,0,0,0,0,0,
            0,0,0,0,0,0,0,0,0,
            0,0,0,0,0,0,0,0,0,
            1,0,0,1,0,0,0,0,0
        ]
    },
    "collectable": ""
}
