{
    "data": {
        "moves": 36,
        "gems": [
            {
                "type": "coins",
                "amount": 25
            },
            {
                "type": "red",
                "amount": 25
            },
            {
                "type": "green",
                "amount": 25
            },
            {
                "type": "blue",
                "amount": 11
            }
        ],
        "objectives": [
            {
                "type": "yellow",
                "amount": 30
            }
        ],
        "spawnRatioDroppable": {
            "gemColor": 0,
            "gemType": 0,
            "minSpawn": 0,
            "maxSpawn": 0,
            "probability": 0
        },
        "spawnRatios": [
            {
                "gemColor": 4,
                "gemType": 7,
                "minSpawn": 1,
                "maxSpawn": 2,
                "probability": 3
            }
        ],
        "hiddenItemName": "monkey"
    },
    "layout": {
        "fields": [
            1,0,0,1,0,0,0,0,0,
            1,0,0,1,1,0,0,0,0,
            1,0,1,2,1,1,0,0,0,
            1,0,1,1,2,1,1,0,0,
            1,0,1,1,1,2,1,1,0,
            1,0,1,1,1,1,2,1,1,
            1,0,1,1,1,1,1,2,1,
            1,0,1,1,1,1,1,1,2,
            1,0,1,1,1,1,1,1,1
        ],
        "tiles": [
            0,0,0,0,0,0,0,0,0,
            0,0,0,0,0,0,0,0,0,
            0,0,0,0,0,0,0,0,0,
            0,0,0,0,0,0,0,0,0,
            0,0,0,0,0,0,0,0,0,
            0,0,0,0,0,0,0,0,0,
            0,0,0,0,0,0,0,0,0,
            0,0,0,0,0,0,0,0,0,
            0,0,0,0,0,0,0,0,0
        ],
        "stones": [
            0,0,0,0,0,0,0,0,0,
            0,0,0,0,0,0,0,0,0,
            0,0,0,0,0,0,0,0,0,
            0,0,0,0,0,0,0,0,0,
            0,0,0,0,0,0,0,0,0,
            0,0,0,0,0,0,0,0,0,
            0,0,0,0,0,0,0,0,0,
            0,0,0,0,0,0,0,0,0,
            0,0,0,0,0,0,0,0,0
        ],
        "spawning": [
            1,0,0,1,0,0,0,0,0,
            0,0,0,0,1,0,0,0,0,
            0,0,1,0,0,1,0,0,0,
            0,0,0,0,0,0,1,0,0,
            0,0,0,0,0,0,0,1,0,
            0,0,0,0,0,0,0,0,1,
            0,0,0,0,0,0,0,0,0,
            0,0,0,0,0,0,0,0,0,
            0,0,0,0,0,0,0,0,0
        ],
        "dropItems": [
            0,0,0,0,0,0,0,0,0,
            0,0,0,0,0,0,0,0,0,
            0,0,0,0,0,0,0,0,0,
            0,0,0,0,0,0,0,0,0,
            0,0,0,0,0,0,0,0,0,
            0,0,0,0,0,0,0,0,0,
            0,0,0,0,0,0,0,0,0,
            0,0,0,0,0,0,0,0,0,
            0,0,0,0,0,0,0,0,0
        ],
        "chains": [
            0,0,0,1,0,0,0,0,0,
            0,0,0,1,1,0,0,0,0,
            0,0,0,0,1,1,0,0,0,
            0,0,0,0,0,1,1,0,0,
            0,0,0,0,0,0,1,1,0,
            0,0,0,0,0,0,0,1,1,
            0,0,0,0,0,0,0,0,1,
            0,0,0,0,0,0,0,0,0,
            0,0,0,0,0,0,0,0,0
        ],
        "hiddenItems": [
            0,0,0,0,0,0,0,0,0,
            0,0,0,0,0,0,0,0,0,
            0,0,0,0,0,0,0,0,0,
            0,0,0,0,0,0,0,0,0,
            0,0,0,0,0,0,0,0,0,
            0,0,0,0,0,0,0,0,0,
            0,0,0,0,0,0,0,0,0,
            0,0,0,0,0,0,0,0,0,
            0,0,0,0,0,0,0,0,0
        ],
        "gemColors": [
            2,0,0,4,0,0,0,0,0,
            3,0,0,10,4,0,0,0,0,
            2,0,8,0,10,4,0,0,0,
            4,0,8,8,0,10,4,0,0,
            3,0,8,8,8,0,10,4,0,
            4,0,8,8,8,8,0,10,4,
            2,0,10,8,8,8,8,0,10,
            3,0,10,10,8,8,8,8,0,
            2,0,10,10,10,8,8,8,8
        ],
        "gemTypes": [
            10,0,0,7,0,0,0,0,0,
            10,0,0,0,7,0,0,0,0,
            10,0,0,0,0,7,0,0,0,
            10,0,0,0,0,0,7,0,0,
            10,0,0,0,0,0,0,7,0,
            10,0,0,0,0,0,0,0,7,
            10,0,0,0,0,0,0,0,0,
            10,0,0,0,0,0,0,0,0,
            10,0,0,0,0,0,0,0,0
        ],
        "gemModifier": [
            7,0,0,0,0,0,0,0,0,
            7,0,0,0,0,0,0,0,0,
            8,0,0,0,0,0,0,0,0,
            7,0,0,0,0,0,0,0,0,
            7,0,0,0,0,0,0,0,0,
            7,0,0,0,0,0,0,0,0,
            8,0,0,0,0,0,0,0,0,
            7,0,0,0,0,0,0,0,0,
            7,0,0,0,0,0,0,0,0
        ],
        "portals": [
            0,0,0,0,0,0,0,0,0,
            0,0,0,0,0,0,0,0,0,
            0,0,0,0,0,0,0,0,0,
            0,0,0,0,0,0,0,0,0,
            0,0,0,0,0,0,0,0,0,
            0,0,0,0,0,0,0,0,0,
            0,0,0,0,0,0,0,0,0,
            0,0,0,0,0,0,0,0,0,
            0,0,0,0,0,0,0,0,0
        ],
        "crates": [
            0,0,0,0,0,0,0,0,0,
            0,0,0,0,0,0,0,0,0,
            0,0,0,0,0,0,0,0,0,
            0,0,0,0,0,0,0,0,0,
            0,0,0,0,0,0,0,0,0,
            0,0,0,0,0,0,0,0,0,
            0,0,0,0,0,0,0,0,0,
            0,0,0,0,0,0,0,0,0,
            0,0,0,0,0,0,0,0,0
        ],
        "climbers": [
            0,0,0,0,0,0,0,0,0,
            0,0,0,0,0,0,0,0,0,
            0,0,0,0,0,0,0,0,0,
            0,0,0,0,0,0,0,0,0,
            0,0,0,0,0,0,0,0,0,
            0,0,0,0,0,0,0,0,0,
            0,0,0,0,0,0,0,0,0,
            0,0,0,0,0,0,0,0,0,
            0,0,0,0,0,0,0,0,0
        ]
    },
    "collectable": ""
}
