{
    "data": {
        "moves": 37,
        "gems": [
            {
                "type": "coins",
                "amount": 25
            },
            {
                "type": "red",
                "amount": 25
            },
            {
                "type": "green",
                "amount": 25
            },
            {
                "type": "yellow",
                "amount": 25
            }
        ],
        "objectives": [
            {
                "type": "climber",
                "amount": 3
            }
        ],
        "spawnRatioDroppable": {
            "gemColor": 0,
            "gemType": 0,
            "minSpawn": 0,
            "maxSpawn": 0,
            "probability": 0
        },
        "spawnRatios": [
            
        ],
        "hiddenItemName": "monkey"
    },
    "layout": {
        "fields": [
            1,1,1,1,1,1,1,1,1,
            1,1,1,1,1,1,1,1,1,
            1,1,1,1,1,1,1,1,1,
            1,1,1,1,0,0,1,1,1,
            1,1,1,1,1,1,0,1,1,
            0,0,0,0,1,1,0,1,1,
            1,1,1,1,1,1,0,1,1,
            1,1,1,1,1,1,1,1,1,
            1,1,1,1,1,1,0,1,1
        ],
        "tiles": [
            2,2,2,0,0,0,0,0,0,
            2,2,2,0,0,2,2,2,2,
            2,2,2,0,0,2,2,2,2,
            2,2,2,0,0,0,0,2,2,
            2,2,2,0,2,2,0,2,2,
            0,0,0,0,2,2,0,2,2,
            2,2,2,2,2,2,0,2,2,
            2,0,2,2,2,2,0,2,2,
            2,2,2,2,2,2,0,2,2
        ],
        "stones": [
            5,4,3,3,1,1,1,2,3,
            5,4,3,3,1,9,10,3,2,
            5,4,3,3,1,10,10,2,3,
            9,10,3,3,0,0,0,3,2,
            10,10,3,3,0,0,0,2,3,
            0,0,0,0,0,0,0,3,2,
            0,0,0,0,0,0,0,2,3,
            0,0,0,0,0,0,0,3,2,
            0,0,0,0,0,0,0,2,0
        ],
        "spawning": [
            1,1,1,1,1,1,1,1,1,
            0,0,0,0,0,0,0,0,0,
            0,0,0,0,0,0,0,0,0,
            0,0,0,0,0,0,2,0,0,
            0,0,0,0,1,1,0,0,0,
            0,0,0,0,0,0,0,0,0,
            1,1,1,1,0,0,0,0,0,
            0,2,0,0,0,0,2,0,0,
            0,0,0,0,0,0,0,0,0
        ],
        "dropItems": [
            0,0,0,0,0,0,0,0,0,
            0,0,0,0,0,0,0,0,0,
            0,0,0,0,0,0,0,0,0,
            0,0,0,0,0,0,0,0,0,
            0,0,0,0,0,0,0,0,0,
            0,0,0,0,0,0,0,0,0,
            0,0,0,0,0,0,0,0,0,
            0,0,0,0,0,0,0,0,0,
            0,0,0,0,0,0,0,0,0
        ],
        "chains": [
            0,0,0,0,0,0,0,0,0,
            0,0,0,0,0,0,0,0,0,
            0,0,0,0,0,0,0,0,0,
            0,0,0,0,0,0,0,0,0,
            0,0,0,0,0,0,0,0,0,
            0,0,0,0,0,0,0,0,0,
            0,0,0,0,0,0,0,0,0,
            0,0,0,0,0,0,0,0,0,
            0,0,0,0,0,0,0,0,0
        ],
        "hiddenItems": [
            0,0,0,0,0,0,0,0,0,
            6,6,0,0,0,3,3,0,0,
            6,6,0,0,0,3,3,0,0,
            2,2,0,0,0,0,0,4,4,
            2,2,0,0,0,0,0,4,4,
            0,0,0,0,1,1,0,0,0,
            0,0,7,7,1,1,0,8,8,
            0,0,7,7,5,5,0,8,8,
            0,0,0,0,5,5,0,0,0
        ],
        "gemColors": [
            0,0,0,0,0,0,0,0,0,
            0,0,0,0,0,0,0,0,0,
            0,0,0,0,0,0,0,0,0,
            0,0,0,0,0,0,8,0,0,
            0,0,0,0,8,8,0,0,0,
            0,0,0,0,8,8,0,0,0,
            8,8,8,8,8,8,0,0,0,
            8,8,8,8,8,8,8,0,0,
            8,8,8,8,8,8,0,0,12
        ],
        "gemTypes": [
            0,0,0,0,0,0,0,0,0,
            0,0,0,0,0,0,0,0,0,
            0,0,0,0,0,0,0,0,0,
            0,0,0,0,0,0,6,0,0,
            0,0,0,0,0,0,0,0,0,
            0,0,0,0,0,0,0,0,0,
            0,0,0,0,0,0,0,0,0,
            0,6,0,0,0,0,6,0,0,
            0,0,0,0,0,0,0,0,0
        ],
        "gemModifier": [
            0,0,0,0,0,0,0,0,0,
            0,0,0,0,0,0,0,0,0,
            0,0,0,0,0,0,0,0,0,
            0,0,0,0,0,0,0,0,0,
            0,0,0,0,0,0,0,0,0,
            0,0,0,0,0,0,0,0,0,
            0,0,0,0,0,0,0,0,0,
            0,0,0,0,0,0,0,0,0,
            0,0,0,0,0,0,0,0,0
        ],
        "portals": [
            0,0,0,0,0,0,0,0,0,
            0,0,0,0,0,0,0,0,0,
            0,0,0,0,0,0,0,0,0,
            0,0,0,0,0,0,0,0,0,
            0,0,0,0,0,0,0,0,0,
            0,0,0,0,0,0,0,0,0,
            0,0,0,0,0,0,0,0,0,
            0,0,0,0,0,0,0,0,0,
            0,0,0,0,0,0,0,0,0
        ],
        "crates": [
            0,0,0,0,0,0,0,0,0,
            0,0,0,0,0,0,0,0,0,
            0,0,0,0,0,0,0,0,0,
            0,0,0,0,0,0,0,0,0,
            0,0,0,0,0,0,0,0,0,
            0,0,0,0,0,0,0,0,0,
            0,0,0,0,0,0,0,0,0,
            0,0,0,0,0,0,0,0,0,
            0,0,0,0,0,0,0,0,0
        ],
        "climbers": [
            2,2,2,2,2,2,2,2,2,
            0,0,0,0,0,0,0,0,0,
            0,0,0,0,0,0,0,0,0,
            0,0,0,0,0,0,0,0,0,
            0,0,0,1,2,2,0,0,0,
            0,0,0,0,0,0,0,0,0,
            2,2,2,2,0,0,0,0,0,
            0,0,0,0,0,0,0,0,0,
            0,0,0,0,0,0,0,0,0
        ]
    },
    "collectable": ""
}
