{
    "data": {
        "moves": 41,
        "gems": [
            {
                "type": "coins",
                "amount": 25
            },
            {
                "type": "red",
                "amount": 25
            },
            {
                "type": "orange",
                "amount": 25
            },
            {
                "type": "blue",
                "amount": 25
            },
            {
                "type": "purple",
                "amount": 7
            }
        ],
        "objectives": [
            
        ],
        "spawnRatioDroppable": {
            "gemColor": 0,
            "gemType": 0,
            "minSpawn": 0,
            "maxSpawn": 0,
            "probability": 0
        },
        "spawnRatios": [
            
        ],
        "hiddenItemName": "monkey"
    },
    "layout": {
        "fields": [
            1,1,1,0,0,1,1,1,1,
            1,1,1,0,0,1,1,1,1,
            1,1,1,0,1,1,1,1,1,
            1,1,0,0,1,1,1,1,1,
            1,1,1,1,1,1,1,1,1,
            1,1,1,1,1,0,0,1,1,
            1,1,1,1,1,0,1,1,1,
            1,1,1,1,0,0,1,1,1,
            1,1,1,1,0,0,1,1,1
        ],
        "tiles": [
            1,1,1,0,0,2,2,0,0,
            2,2,2,0,0,2,2,0,0,
            2,2,2,0,2,2,2,0,0,
            0,0,0,0,2,2,2,0,0,
            0,0,2,2,2,2,2,0,0,
            0,0,2,2,2,0,0,0,0,
            0,0,2,2,2,0,2,2,2,
            0,0,2,2,0,0,2,2,2,
            0,0,2,2,0,0,1,1,1
        ],
        "stones": [
            0,0,0,0,0,0,0,0,0,
            0,0,0,0,0,0,0,0,0,
            0,0,0,0,0,0,0,0,0,
            0,0,0,0,0,0,0,0,0,
            0,0,0,0,0,0,0,0,0,
            0,0,0,0,0,0,0,0,0,
            0,0,0,0,0,0,0,0,0,
            0,0,0,0,0,0,0,0,0,
            0,0,0,0,0,0,0,0,0
        ],
        "spawning": [
            0,0,0,0,0,1,1,1,1,
            0,0,0,0,0,0,0,0,0,
            0,0,0,0,1,0,0,0,0,
            0,0,0,0,0,0,0,0,0,
            0,0,1,1,0,0,0,0,0,
            0,0,0,0,0,0,0,0,0,
            0,0,0,0,0,0,1,0,0,
            0,0,0,0,0,0,0,0,0,
            0,0,0,0,0,0,0,0,0
        ],
        "dropItems": [
            0,0,0,0,0,0,0,0,0,
            0,0,0,0,0,0,0,0,0,
            0,0,0,0,0,0,0,0,0,
            0,0,0,0,0,0,0,0,0,
            0,0,0,0,0,0,0,0,0,
            0,0,0,0,0,0,0,0,0,
            0,0,0,0,0,0,0,0,0,
            0,0,0,0,0,0,0,0,0,
            0,0,0,0,0,0,0,0,0
        ],
        "chains": [
            3,0,3,0,0,2,0,0,0,
            0,3,0,0,0,0,2,0,0,
            3,0,3,0,0,2,0,0,0,
            0,0,0,0,3,0,2,0,0,
            0,0,0,3,0,3,0,0,0,
            0,0,2,0,3,0,0,0,0,
            0,0,0,2,0,0,3,0,3,
            0,0,2,0,0,0,0,3,0,
            0,0,0,2,0,0,3,0,3
        ],
        "hiddenItems": [
            1,1,1,0,0,7,7,0,0,
            1,1,1,0,0,7,7,0,0,
            1,1,1,0,5,5,5,0,0,
            0,0,0,0,5,5,5,0,0,
            0,0,0,0,5,5,5,0,0,
            0,0,6,6,0,0,0,0,0,
            0,0,6,6,0,0,2,2,2,
            0,0,3,3,0,0,2,2,2,
            0,0,3,3,0,0,2,2,2
        ],
        "gemColors": [
            8,8,8,0,0,8,8,8,8,
            8,8,8,0,0,8,8,8,8,
            8,8,8,0,8,8,8,8,8,
            8,8,0,0,8,8,8,8,8,
            8,8,8,8,8,8,8,8,8,
            8,8,8,8,8,0,0,8,8,
            8,8,8,8,8,0,8,8,8,
            8,8,8,8,0,0,8,8,8,
            8,8,8,8,0,0,8,8,8
        ],
        "gemTypes": [
            0,0,0,0,0,0,0,0,0,
            0,0,0,0,0,0,0,0,0,
            0,0,0,0,0,0,0,0,0,
            0,0,0,0,0,0,0,0,0,
            0,0,0,0,0,0,0,0,0,
            0,0,0,0,0,0,0,0,0,
            0,0,0,0,0,0,0,0,0,
            0,0,0,0,0,0,0,0,0,
            0,0,0,0,0,0,0,0,0
        ],
        "gemModifier": [
            0,0,0,0,0,0,0,0,0,
            0,0,0,0,0,0,0,0,0,
            0,0,0,0,0,0,0,0,0,
            0,0,0,0,0,0,0,0,0,
            0,0,0,0,0,0,0,0,0,
            0,0,0,0,0,0,0,0,0,
            0,0,0,0,0,0,0,0,0,
            0,0,0,0,0,0,0,0,0,
            0,0,0,0,0,0,0,0,0
        ],
        "portals": [
            2,4,6,0,0,0,0,0,0,
            0,0,0,0,0,0,0,0,0,
            0,0,0,0,0,0,0,0,0,
            0,0,0,0,0,0,0,0,0,
            0,0,0,0,0,0,0,0,0,
            0,0,0,0,0,0,0,0,0,
            0,0,0,0,0,0,0,0,0,
            0,0,0,0,0,0,0,0,0,
            0,0,0,0,0,0,1,3,5
        ],
        "crates": [
            0,0,0,0,0,0,0,0,0,
            0,0,0,0,0,0,0,0,0,
            0,0,0,0,0,0,0,0,0,
            0,0,0,0,0,0,0,0,0,
            0,0,0,0,0,0,0,0,0,
            0,0,0,0,0,0,0,0,0,
            0,0,0,0,0,0,0,0,0,
            0,0,0,0,0,0,0,0,0,
            0,0,0,0,0,0,0,0,0
        ],
        "climbers": [
            0,0,0,0,0,0,0,0,0,
            0,0,0,0,0,0,0,0,0,
            0,0,0,0,0,0,0,0,0,
            0,0,0,0,0,0,0,0,0,
            0,0,0,0,0,0,0,0,0,
            0,0,0,0,0,0,0,0,0,
            0,0,0,0,0,0,0,0,0,
            0,0,0,0,0,0,0,0,0,
            0,0,0,0,0,0,0,0,0
        ]
    },
    "collectable": ""
}
