{
    "data": {
        "moves": 25,
        "gems": [
            {
                "type": "coins",
                "amount": 25,
                "units": 0,
                "period": 0,
                "maxAmount": 0,
                "usage": 0
            },
            {
                "type": "red",
                "amount": 25,
                "units": 0,
                "period": 0,
                "maxAmount": 0,
                "usage": 0
            },
            {
                "type": "green",
                "amount": 25,
                "units": 0,
                "period": 0,
                "maxAmount": 0,
                "usage": 0
            },
            {
                "type": "yellow",
                "amount": 25,
                "units": 0,
                "period": 0,
                "maxAmount": 0,
                "usage": 0
            },
            {
                "type": "orange",
                "amount": 22,
                "units": 0,
                "period": 0,
                "maxAmount": 0,
                "usage": 0
            }
        ],
        "objectives": [
            {
                "type": "climber",
                "amount": 1,
                "units": 0,
                "period": 0,
                "maxAmount": 0,
                "usage": 0
            }
        ],
        "spawnRatioDroppable": {
            "gemColor": 0,
            "gemType": 0,
            "minSpawn": 0,
            "maxSpawn": 0,
            "probability": 0
        },
        "spawnRatios": [
            {
                "gemColor": 8,
                "gemType": 6,
                "minSpawn": 1,
                "maxSpawn": 3,
                "probability": 5
            }
        ],
        "hiddenItemName": "monkey"
    },
    "layout": {
        "fields": [
            1,1,1,0,0,0,1,1,1,
            1,1,1,0,0,0,1,1,1,
            1,1,1,1,1,1,1,1,1,
            1,1,1,1,1,1,1,1,1,
            1,1,1,1,1,1,1,1,1,
            1,1,1,1,1,1,1,1,1,
            1,1,1,1,1,1,1,1,1,
            1,1,1,0,0,0,1,1,1,
            1,1,1,0,0,0,1,1,1
        ],
        "tiles": [
            0,0,0,0,0,0,0,0,0,
            0,0,0,0,0,0,0,0,0,
            0,0,0,0,0,0,0,0,0,
            0,0,0,0,0,0,0,0,0,
            0,0,0,0,0,0,0,0,0,
            0,0,0,0,0,0,0,0,0,
            0,0,0,0,0,0,0,0,0,
            0,0,0,0,0,0,0,0,0,
            0,0,0,0,0,0,0,0,0
        ],
        "stones": [
            0,0,0,0,0,0,0,0,0,
            0,0,0,0,0,0,0,0,0,
            0,0,0,0,0,0,0,0,0,
            0,0,0,0,0,0,0,0,0,
            0,0,0,0,0,0,0,0,0,
            0,0,0,0,0,0,0,0,0,
            0,0,0,0,0,0,0,0,0,
            0,0,0,0,0,0,0,0,0,
            0,0,0,0,0,0,0,0,0
        ],
        "spawning": [
            1,1,1,0,0,0,1,1,1,
            0,0,0,0,0,0,0,0,0,
            0,0,0,1,1,1,0,0,0,
            0,0,0,0,0,0,0,0,0,
            0,0,0,0,0,0,0,0,0,
            0,0,0,0,0,0,0,0,0,
            0,0,0,0,0,0,0,0,0,
            0,0,0,0,0,0,0,0,0,
            0,0,0,0,0,0,0,0,0
        ],
        "dropItems": [
            0,0,0,0,0,0,0,0,0,
            0,0,0,0,0,0,0,0,0,
            0,0,0,0,0,0,0,0,0,
            0,0,0,0,0,0,0,0,0,
            0,0,0,0,0,0,0,0,0,
            0,0,0,0,0,0,0,0,0,
            0,0,0,0,0,0,0,0,0,
            0,0,0,0,0,0,0,0,0,
            0,0,0,0,0,0,0,0,0
        ],
        "chains": [
            0,0,0,0,0,0,0,0,0,
            0,0,0,0,0,0,0,0,0,
            0,0,0,0,0,0,0,0,0,
            0,0,0,0,0,0,0,0,0,
            0,0,0,0,0,0,0,0,0,
            0,0,0,0,0,0,0,0,0,
            0,0,0,0,0,0,0,0,0,
            0,0,0,0,0,0,0,0,0,
            0,0,0,0,0,0,0,0,0
        ],
        "hiddenItems": [
            0,0,0,0,0,0,0,0,0,
            0,0,0,0,0,0,0,0,0,
            0,0,0,0,0,0,0,0,0,
            0,0,0,0,0,0,0,0,0,
            0,0,0,0,0,0,0,0,0,
            0,0,0,0,0,0,0,0,0,
            0,0,0,0,0,0,0,0,0,
            0,0,0,0,0,0,0,0,0,
            0,0,0,0,0,0,0,0,0
        ],
        "gemColors": [
            8,8,8,0,0,0,8,8,8,
            8,8,8,0,0,0,8,8,8,
            8,8,8,8,8,8,8,8,8,
            8,8,8,8,8,8,8,8,8,
            8,8,8,8,8,8,8,8,8,
            8,8,8,8,8,8,8,8,8,
            8,8,8,8,8,8,8,8,8,
            8,8,8,0,0,0,8,8,8,
            8,12,8,0,0,0,8,8,8
        ],
        "gemTypes": [
            0,0,0,0,0,0,0,0,0,
            0,0,0,0,0,0,0,6,0,
            0,0,0,0,0,0,0,0,0,
            0,0,0,0,6,0,6,0,0,
            0,0,0,0,6,0,6,0,6,
            0,0,0,0,6,0,6,0,6,
            0,0,0,0,0,0,0,0,0,
            0,0,0,0,0,0,0,6,0,
            0,0,0,0,0,0,0,0,0
        ],
        "gemModifier": [
            0,0,0,0,0,0,1,1,1,
            0,0,0,0,0,0,1,1,1,
            0,0,0,1,1,1,1,1,1,
            0,0,0,1,0,1,0,1,0,
            0,0,0,2,0,2,0,2,0,
            0,0,0,1,0,1,0,1,0,
            0,0,0,1,1,1,1,1,1,
            0,0,0,0,0,0,1,1,1,
            0,0,0,0,0,0,1,1,1
        ],
        "portals": [
            0,0,0,0,0,0,0,0,0,
            0,0,0,0,0,0,0,0,0,
            0,0,0,0,0,0,0,0,0,
            0,0,0,0,0,0,0,0,0,
            0,0,0,0,0,0,0,0,0,
            0,0,0,0,0,0,0,0,0,
            0,0,0,0,0,0,0,0,0,
            0,0,0,0,0,0,0,0,0,
            0,0,0,0,0,0,0,0,0
        ],
        "crates": [
            0,0,0,0,0,0,0,0,0,
            0,0,0,0,0,0,0,0,0,
            0,0,0,0,0,0,0,0,0,
            0,0,0,0,1,0,1,0,1,
            0,0,0,0,2,0,2,0,2,
            0,0,0,0,1,0,1,0,1,
            0,0,0,0,0,0,0,0,0,
            0,0,0,0,0,0,0,0,0,
            0,0,0,0,0,0,0,0,0
        ],
        "climbers": [
            2,2,2,0,0,0,0,0,0,
            0,0,0,0,0,0,0,0,0,
            0,0,0,0,0,0,0,0,0,
            0,0,0,0,0,0,0,0,0,
            0,0,0,0,0,0,0,0,0,
            0,0,0,0,0,0,0,0,0,
            0,0,0,0,0,0,0,0,0,
            0,0,0,0,0,0,0,0,0,
            1,1,1,0,0,0,0,0,0
        ]
    },
    "collectable": ""
}
