{
    "data": {
        "moves": 29,
        "gems": [
            {
                "type": "coins",
                "amount": 25
            },
            {
                "type": "purple",
                "amount": 25
            },
            {
                "type": "red",
                "amount": 25
            },
            {
                "type": "yellow",
                "amount": 25
            },
            {
                "type": "blue",
                "amount": 1
            }
        ],
        "objectives": [
            {
                "type": "droppable",
                "amount": 6
            }
        ],
        "spawnRatioDroppable": {
            "gemColor": 0,
            "gemType": 0,
            "minSpawn": 0,
            "maxSpawn": 0,
            "probability": 0
        },
        "spawnRatios": [
            
        ],
        "hiddenItemName": "monkey"
    },
    "layout": {
        "fields": [
            1,1,1,1,1,1,1,1,1,
            1,1,1,1,2,1,1,1,1,
            1,1,1,2,1,2,1,1,1,
            1,1,2,1,2,1,2,1,1,
            1,1,1,1,1,1,1,1,1,
            1,1,1,1,1,1,1,1,1,
            1,1,1,2,1,2,1,1,1,
            1,1,2,1,2,1,2,1,1,
            1,1,1,1,1,1,1,1,1
        ],
        "tiles": [
            0,0,0,0,0,0,0,0,0,
            0,0,0,0,0,0,0,0,0,
            0,0,0,0,0,0,0,0,0,
            0,0,0,0,0,0,0,0,0,
            0,0,0,0,0,0,0,0,0,
            0,0,0,0,0,0,0,0,0,
            0,0,0,0,0,0,0,0,0,
            0,0,0,0,0,0,0,0,0,
            0,0,0,0,0,0,0,0,0
        ],
        "stones": [
            0,0,0,0,0,0,0,0,0,
            0,0,0,0,0,0,0,0,0,
            0,0,0,0,0,0,0,0,0,
            0,0,0,0,0,0,0,0,0,
            0,0,2,2,2,2,2,0,0,
            0,0,0,0,2,0,0,0,0,
            0,0,0,0,0,0,0,0,0,
            0,1,0,0,0,0,0,1,0,
            1,1,2,2,2,2,2,1,1
        ],
        "spawning": [
            1,1,1,1,1,1,1,1,1,
            0,0,0,0,0,0,0,0,0,
            0,0,0,0,0,0,0,0,0,
            0,0,0,0,0,0,0,0,0,
            0,0,0,0,0,0,0,0,0,
            0,0,0,0,0,0,0,0,0,
            0,0,0,0,0,0,0,0,0,
            0,0,0,0,0,0,0,0,0,
            0,0,0,0,0,0,0,0,0
        ],
        "dropItems": [
            0,0,0,0,0,0,0,0,0,
            0,0,0,0,0,0,0,0,0,
            0,0,0,0,0,0,0,0,0,
            0,0,0,0,0,0,0,0,0,
            0,0,0,0,0,0,0,0,0,
            0,0,0,0,0,0,0,0,0,
            0,0,0,0,0,0,0,0,0,
            0,0,0,0,0,0,0,0,0,
            0,2,2,2,2,2,2,2,0
        ],
        "chains": [
            0,0,0,0,0,0,0,0,0,
            0,0,0,0,0,0,0,0,0,
            0,0,0,0,0,0,0,0,0,
            0,0,0,0,0,0,0,0,0,
            0,0,0,0,0,0,0,0,0,
            0,0,0,0,0,0,0,0,0,
            0,0,0,0,0,0,0,0,0,
            0,0,0,0,0,0,0,0,0,
            0,0,0,0,0,0,0,0,0
        ],
        "hiddenItems": [
            0,0,0,0,0,0,0,0,0,
            0,0,0,0,0,0,0,0,0,
            0,0,0,0,0,0,0,0,0,
            0,0,0,0,0,0,0,0,0,
            0,0,0,0,0,0,0,0,0,
            0,0,0,0,0,0,0,0,0,
            0,0,0,0,0,0,0,0,0,
            0,0,0,0,0,0,0,0,0,
            0,0,0,0,0,0,0,0,0
        ],
        "gemColors": [
            8,8,8,8,8,8,8,8,8,
            8,8,8,8,0,8,8,8,8,
            8,8,8,0,7,0,8,8,8,
            8,8,0,7,0,7,0,8,8,
            8,8,0,0,0,0,0,8,8,
            8,8,8,8,0,8,8,8,8,
            8,8,8,0,7,0,8,8,8,
            8,0,0,7,0,7,0,0,8,
            0,0,0,0,0,0,0,0,0
        ],
        "gemTypes": [
            0,0,0,0,0,0,0,0,0,
            0,0,0,0,0,0,0,0,0,
            0,0,0,0,0,0,0,0,0,
            0,0,0,0,0,0,0,0,0,
            0,0,0,0,0,0,0,0,0,
            0,0,0,0,0,0,0,0,0,
            0,0,0,0,0,0,0,0,0,
            0,0,0,0,0,0,0,0,0,
            0,0,0,0,0,0,0,0,0
        ],
        "gemModifier": [
            0,0,0,0,0,0,0,0,0,
            0,0,0,0,0,0,0,0,0,
            0,0,0,0,0,0,0,0,0,
            0,0,0,0,0,0,0,0,0,
            0,0,0,0,0,0,0,0,0,
            0,0,0,0,0,0,0,0,0,
            0,0,0,0,0,0,0,0,0,
            0,0,0,0,0,0,0,0,0,
            0,0,0,0,0,0,0,0,0
        ],
        "portals": [
            0,0,0,0,0,0,0,0,0,
            0,0,0,0,0,0,0,0,0,
            0,0,0,0,0,0,0,0,0,
            0,0,0,0,0,0,0,0,0,
            0,0,0,0,0,0,0,0,0,
            0,0,0,0,0,0,0,0,0,
            0,0,0,0,0,0,0,0,0,
            0,0,0,0,0,0,0,0,0,
            0,0,0,0,0,0,0,0,0
        ],
        "crates": [
            0,0,0,0,0,0,0,0,0,
            0,0,0,0,0,0,0,0,0,
            0,0,0,0,0,0,0,0,0,
            0,0,0,0,0,0,0,0,0,
            0,0,0,0,0,0,0,0,0,
            0,0,0,0,0,0,0,0,0,
            0,0,0,0,0,0,0,0,0,
            0,0,0,0,0,0,0,0,0,
            0,0,0,0,0,0,0,0,0
        ],
        "climbers": [
            0,0,0,0,0,0,0,0,0,
            0,0,0,0,0,0,0,0,0,
            0,0,0,0,0,0,0,0,0,
            0,0,0,0,0,0,0,0,0,
            0,0,0,0,0,0,0,0,0,
            0,0,0,0,0,0,0,0,0,
            0,0,0,0,0,0,0,0,0,
            0,0,0,0,0,0,0,0,0,
            0,0,0,0,0,0,0,0,0
        ]
    },
    "collectable": ""
}
