{
    "data": {
        "moves": 40,
        "gems": [
            {
                "type": "coins",
                "amount": 25
            },
            {
                "type": "orange",
                "amount": 25
            },
            {
                "type": "purple",
                "amount": 25
            },
            {
                "type": "yellow",
                "amount": 25
            },
            {
                "type": "red",
                "amount": 25
            }
        ],
        "objectives": [
            {
                "type": "orange",
                "amount": 140
            }
        ],
        "spawnRatioDroppable": {
            "gemColor": 0,
            "gemType": 0,
            "minSpawn": 0,
            "maxSpawn": 0,
            "probability": 0
        },
        "spawnRatios": [
            {
                "gemColor": 6,
                "gemType": 7,
                "minSpawn": 0,
                "maxSpawn": 2,
                "probability": 2
            },
            {
                "gemColor": 6,
                "gemType": 8,
                "minSpawn": 0,
                "maxSpawn": 1,
                "probability": 2
            },
            {
                "gemColor": 10,
                "gemType": 0,
                "minSpawn": 0,
                "maxSpawn": 9,
                "probability": 8
            }
        ],
        "hiddenItemName": "monkey"
    },
    "layout": {
        "fields": [
            1,1,1,1,1,1,1,1,1,
            1,1,1,1,1,1,1,1,1,
            1,1,1,1,2,2,2,2,2,
            1,1,1,1,1,2,1,1,1,
            1,1,1,1,1,1,1,1,1,
            1,1,1,1,1,2,1,1,1,
            1,1,1,1,2,2,2,2,2,
            1,1,1,1,1,1,1,1,1,
            1,1,1,1,1,1,1,1,1
        ],
        "tiles": [
            0,0,0,0,0,0,0,0,0,
            0,0,0,0,0,0,0,0,0,
            0,0,0,0,0,0,0,0,0,
            0,0,0,0,0,0,0,0,0,
            0,0,0,0,0,0,0,0,0,
            0,0,0,0,0,0,0,0,0,
            0,0,0,0,0,0,0,0,0,
            0,0,0,0,0,0,0,0,0,
            0,0,0,0,0,0,0,0,0
        ],
        "stones": [
            0,0,0,0,0,0,0,0,0,
            0,0,0,0,0,0,0,0,0,
            0,0,0,0,0,0,0,0,0,
            0,0,0,0,0,0,0,0,0,
            0,0,0,0,0,0,0,0,0,
            0,0,0,0,0,0,0,0,0,
            0,0,0,0,0,0,0,0,0,
            0,0,0,0,0,0,0,0,0,
            0,0,0,0,0,0,0,0,0
        ],
        "spawning": [
            1,1,1,1,1,1,1,1,1,
            0,0,0,0,0,0,0,0,0,
            0,0,0,0,0,0,0,0,0,
            0,0,0,0,0,0,0,0,0,
            0,0,0,0,0,0,0,0,0,
            0,0,0,0,0,0,0,0,0,
            0,0,0,0,0,0,0,0,0,
            0,0,0,0,0,0,0,0,0,
            0,0,0,0,0,0,0,0,0
        ],
        "dropItems": [
            0,0,0,0,0,0,0,0,0,
            0,0,0,0,0,0,0,0,0,
            0,0,0,0,0,0,0,0,0,
            0,0,0,0,0,0,0,0,0,
            0,0,0,0,0,0,0,0,0,
            0,0,0,0,0,0,0,0,0,
            0,0,0,0,0,0,0,0,0,
            0,0,0,0,0,0,0,0,0,
            0,0,0,0,0,0,0,0,0
        ],
        "chains": [
            0,0,0,0,0,0,0,0,0,
            0,0,0,0,0,0,0,0,0,
            0,0,0,0,0,0,0,0,0,
            0,0,0,0,0,0,0,0,0,
            0,0,0,0,0,0,0,0,0,
            0,0,0,0,0,0,0,0,0,
            0,0,0,0,0,0,0,0,0,
            0,0,0,0,0,0,0,0,0,
            0,0,0,0,0,0,0,0,0
        ],
        "hiddenItems": [
            0,0,0,0,0,0,0,0,0,
            0,0,0,0,0,0,0,0,0,
            0,0,0,0,0,0,0,0,0,
            0,0,0,0,0,0,0,0,0,
            0,0,0,0,0,0,0,0,0,
            0,0,0,0,0,0,0,0,0,
            0,0,0,0,0,0,0,0,0,
            0,0,0,0,0,0,0,0,0,
            0,0,0,0,0,0,0,0,0
        ],
        "gemColors": [
            8,8,8,10,6,14,6,14,6,
            8,8,8,10,13,6,10,6,13,
            8,8,8,10,0,0,0,0,0,
            8,10,8,10,6,0,10,6,14,
            10,8,10,10,13,10,6,13,6,
            8,10,8,10,6,0,10,6,13,
            8,8,8,10,0,0,0,0,0,
            8,8,8,10,14,6,10,6,13,
            8,8,8,10,6,13,6,13,6
        ],
        "gemTypes": [
            0,0,0,0,7,0,8,0,0,
            0,0,0,0,0,7,0,7,0,
            0,0,0,0,0,0,0,0,0,
            0,0,0,0,8,0,0,7,0,
            0,0,0,0,0,0,7,0,0,
            0,0,0,0,7,0,0,7,0,
            0,0,0,0,0,0,0,0,0,
            0,0,0,0,0,7,0,7,0,
            0,0,0,0,8,0,7,0,0
        ],
        "gemModifier": [
            0,0,0,0,0,5,0,5,0,
            0,0,0,0,4,0,0,0,5,
            0,0,0,0,0,0,0,0,0,
            0,0,0,0,0,0,0,0,5,
            0,0,0,0,4,0,0,6,0,
            0,0,0,0,0,0,0,0,5,
            0,0,0,0,0,0,0,0,0,
            0,0,0,0,4,0,0,0,5,
            0,0,0,0,0,5,0,5,0
        ],
        "portals": [
            0,0,0,0,0,0,0,0,0,
            0,0,0,0,0,0,0,0,0,
            0,0,0,0,0,0,0,0,0,
            0,0,0,0,0,0,0,0,0,
            0,0,0,0,0,0,0,0,0,
            0,0,0,0,0,0,0,0,0,
            0,0,0,0,0,0,0,0,0,
            0,0,0,0,0,0,0,0,0,
            0,0,0,0,0,0,0,0,0
        ],
        "crates": [
            0,0,0,0,3,0,1,0,3,
            0,0,0,0,0,1,0,1,0,
            0,0,0,0,0,0,0,0,0,
            0,0,0,0,2,0,0,1,0,
            0,0,0,0,0,0,2,0,2,
            0,0,0,0,2,0,0,1,0,
            0,0,0,0,0,0,0,0,0,
            0,0,0,0,0,1,0,1,0,
            0,0,0,0,3,0,1,0,3
        ],
        "climbers": [
            0,0,0,0,0,0,0,0,0,
            0,0,0,0,0,0,0,0,0,
            0,0,0,0,0,0,0,0,0,
            0,0,0,0,0,0,0,0,0,
            0,0,0,0,0,0,0,0,0,
            0,0,0,0,0,0,0,0,0,
            0,0,0,0,0,0,0,0,0,
            0,0,0,0,0,0,0,0,0,
            0,0,0,0,0,0,0,0,0
        ]
    },
    "collectable": ""
}
