{
    "data": {
        "moves": 25,
        "gems": [
            {
                "type": "coins",
                "amount": 25
            },
            {
                "type": "orange",
                "amount": 25
            },
            {
                "type": "green",
                "amount": 25
            },
            {
                "type": "yellow",
                "amount": 25
            },
            {
                "type": "red",
                "amount": 25
            },
            {
                "type": "purple",
                "amount": 13
            }
        ],
        "objectives": [
            {
                "type": "climber",
                "amount": 2
            },
            {
                "type": "droppable",
                "amount": 9
            }
        ],
        "spawnRatioDroppable": {
            "gemColor": 7,
            "gemType": 0,
            "minSpawn": 2,
            "maxSpawn": 6,
            "probability": 5
        },
        "spawnRatios": [
            {
                "gemColor": 8,
                "gemType": 6,
                "minSpawn": 3,
                "maxSpawn": 6,
                "probability": 5
            },
            {
                "gemColor": 2,
                "gemType": 7,
                "minSpawn": 1,
                "maxSpawn": 3,
                "probability": 3
            },
            {
                "gemColor": 4,
                "gemType": 7,
                "minSpawn": 1,
                "maxSpawn": 3,
                "probability": 3
            }
        ],
        "hiddenItemName": "monkey"
    },
    "layout": {
        "fields": [
            1,0,1,1,1,1,1,1,1,
            0,1,0,1,1,1,1,1,1,
            1,0,1,1,1,1,1,1,1,
            1,1,0,1,1,1,1,1,1,
            1,1,1,1,1,1,1,1,1,
            1,1,1,1,1,1,0,1,1,
            1,1,1,1,1,1,1,0,1,
            1,1,1,1,1,1,0,1,0,
            1,1,1,1,1,1,1,0,1
        ],
        "tiles": [
            0,0,0,0,0,0,0,0,0,
            0,0,0,0,0,0,0,0,0,
            0,0,0,0,0,0,0,0,0,
            0,0,0,0,0,0,0,0,0,
            0,0,0,0,0,0,0,0,0,
            0,0,0,0,0,0,0,0,0,
            0,0,0,0,0,0,0,0,0,
            0,0,0,0,0,0,0,0,0,
            0,0,0,0,0,0,0,0,0
        ],
        "stones": [
            0,0,0,0,0,0,0,0,0,
            0,0,0,0,0,0,0,0,0,
            0,0,0,0,0,0,0,0,0,
            0,0,0,0,0,0,0,0,0,
            0,0,0,0,0,0,0,0,0,
            0,0,0,0,0,0,0,0,0,
            0,0,0,0,0,0,0,0,0,
            0,0,0,0,0,0,0,0,0,
            0,0,0,0,0,0,0,0,0
        ],
        "spawning": [
            1,0,1,1,1,1,0,0,0,
            0,0,0,0,0,0,0,0,0,
            0,0,0,0,0,0,0,0,0,
            0,0,0,0,0,0,0,0,0,
            0,0,0,0,0,0,0,0,0,
            0,0,0,0,0,0,0,0,0,
            0,0,0,0,0,0,0,0,0,
            0,0,0,0,0,0,0,0,0,
            0,0,0,0,0,0,0,0,0
        ],
        "dropItems": [
            0,0,0,0,0,0,1,1,1,
            0,0,0,0,0,0,0,0,0,
            1,0,0,0,0,0,0,0,0,
            0,0,0,0,0,0,0,0,0,
            0,0,0,0,0,0,2,0,0,
            0,0,0,0,0,0,0,2,0,
            0,0,0,0,0,0,2,0,2,
            0,0,0,0,0,0,0,2,0,
            2,2,2,2,2,2,2,0,2
        ],
        "chains": [
            0,0,0,0,0,0,3,3,3,
            0,0,0,0,0,0,3,3,1,
            3,0,0,0,0,0,3,2,3,
            1,3,0,0,0,0,1,3,3,
            3,2,3,0,0,0,3,2,3,
            3,3,1,0,0,0,0,3,1,
            3,3,3,2,0,0,0,0,3,
            3,3,1,0,0,0,0,0,0,
            3,1,3,0,0,0,0,0,0
        ],
        "hiddenItems": [
            0,0,0,0,0,0,0,0,0,
            0,0,0,0,0,0,0,0,0,
            0,0,0,0,0,0,0,0,0,
            0,0,0,0,0,0,0,0,0,
            0,0,0,0,0,0,0,0,0,
            0,0,0,0,0,0,0,0,0,
            0,0,0,0,0,0,0,0,0,
            0,0,0,0,0,0,0,0,0,
            0,0,0,0,0,0,0,0,0
        ],
        "gemColors": [
            4,0,8,8,8,8,7,7,7,
            0,4,0,8,8,8,8,8,4,
            7,0,4,8,8,8,8,4,8,
            2,7,0,8,8,8,4,8,8,
            8,2,7,8,8,8,8,4,8,
            8,8,2,8,8,8,0,8,4,
            8,8,8,2,8,8,2,0,8,
            8,8,2,8,8,8,0,2,0,
            8,8,8,8,12,8,8,0,2
        ],
        "gemTypes": [
            10,0,0,0,0,0,0,0,0,
            0,10,0,0,0,0,0,0,7,
            0,0,10,0,0,0,0,7,0,
            7,0,0,0,0,0,7,0,0,
            0,7,0,0,0,0,6,7,0,
            0,0,7,0,0,0,0,6,7,
            0,0,0,7,0,0,10,0,6,
            0,0,7,0,0,0,0,10,0,
            6,6,6,0,0,0,0,0,10
        ],
        "gemModifier": [
            9,0,0,0,0,0,0,0,0,
            0,8,0,0,0,0,0,0,0,
            0,0,7,0,0,0,0,0,0,
            0,0,0,0,0,0,0,0,0,
            0,0,0,0,0,0,0,0,0,
            0,0,0,0,0,0,0,0,0,
            0,0,0,0,0,0,7,0,0,
            0,0,0,0,0,0,0,8,0,
            0,0,0,0,0,0,0,0,9
        ],
        "portals": [
            0,0,0,0,0,0,0,0,0,
            0,0,0,0,0,0,0,0,0,
            0,0,0,0,0,0,0,0,0,
            0,0,0,0,0,0,0,0,0,
            0,0,0,0,0,0,0,0,0,
            0,0,0,0,0,0,0,0,0,
            0,0,0,0,0,0,0,0,0,
            0,0,0,0,0,0,0,0,0,
            0,0,0,0,0,0,0,0,0
        ],
        "crates": [
            0,0,0,0,0,0,0,0,0,
            0,0,0,0,0,0,0,0,0,
            0,0,0,0,0,0,0,0,0,
            0,0,0,0,0,0,0,0,0,
            0,0,0,0,0,0,0,0,0,
            0,0,0,0,0,0,0,0,0,
            0,0,0,0,0,0,0,0,0,
            0,0,0,0,0,0,0,0,0,
            0,0,0,0,0,0,0,0,0
        ],
        "climbers": [
            0,0,2,2,2,2,2,2,2,
            0,0,0,0,0,0,0,0,0,
            0,0,0,0,0,0,0,0,0,
            0,0,0,0,0,0,0,0,0,
            0,0,0,0,0,0,0,0,0,
            0,0,0,0,0,0,0,0,0,
            0,0,0,0,0,0,2,0,0,
            0,0,0,0,0,0,0,0,0,
            0,0,0,0,1,1,2,0,0
        ]
    },
    "collectable": ""
}
