{
    "data": {
        "moves": 26,
        "gems": [
            {
                "type": "coins",
                "amount": 25,
                "units": 0,
                "period": 0,
                "maxAmount": 0,
                "usage": 0
            },
            {
                "type": "red",
                "amount": 25,
                "units": 0,
                "period": 0,
                "maxAmount": 0,
                "usage": 0
            },
            {
                "type": "green",
                "amount": 25,
                "units": 0,
                "period": 0,
                "maxAmount": 0,
                "usage": 0
            },
            {
                "type": "yellow",
                "amount": 25,
                "units": 0,
                "period": 0,
                "maxAmount": 0,
                "usage": 0
            },
            {
                "type": "blue",
                "amount": 17,
                "units": 0,
                "period": 0,
                "maxAmount": 0,
                "usage": 0
            }
        ],
        "objectives": [
            {
                "type": "climber",
                "amount": 2,
                "units": 0,
                "period": 0,
                "maxAmount": 0,
                "usage": 0
            }
        ],
        "spawnRatioDroppable": {
            "gemColor": 0,
            "gemType": 0,
            "minSpawn": 0,
            "maxSpawn": 0,
            "probability": 0
        },
        "spawnRatios": [
            {
                "gemColor": 8,
                "gemType": 6,
                "minSpawn": 2,
                "maxSpawn": 6,
                "probability": 5
            },
            {
                "gemColor": 10,
                "gemType": 0,
                "minSpawn": 0,
                "maxSpawn": 15,
                "probability": 12
            }
        ],
        "hiddenItemName": "monkey"
    },
    "layout": {
        "fields": [
            1,1,1,1,1,1,1,1,1,
            0,1,1,1,0,1,1,1,0,
            1,1,1,0,1,0,1,1,1,
            0,1,1,1,0,1,1,1,0,
            1,1,1,1,1,1,1,1,1,
            0,1,1,1,1,1,1,1,0,
            1,1,1,1,1,1,1,1,1,
            0,1,1,1,1,1,1,1,0,
            1,1,1,1,1,1,1,1,1
        ],
        "tiles": [
            0,0,0,0,0,0,0,0,0,
            0,0,0,0,0,0,0,0,0,
            0,0,0,0,0,0,0,0,0,
            0,0,0,0,0,0,0,0,0,
            0,0,0,0,0,0,0,0,0,
            0,0,0,0,0,0,0,0,0,
            0,0,0,0,0,0,0,0,0,
            0,0,0,0,0,0,0,0,0,
            0,0,0,0,0,0,0,0,0
        ],
        "stones": [
            0,0,0,0,0,0,0,0,0,
            0,0,0,0,0,0,0,0,0,
            0,0,0,0,0,0,0,0,0,
            0,0,0,0,0,0,0,0,0,
            0,0,0,0,0,0,0,0,0,
            0,0,0,0,0,0,0,0,0,
            0,0,0,0,0,0,0,0,0,
            0,0,0,0,0,0,0,0,0,
            0,0,0,0,0,0,0,0,0
        ],
        "spawning": [
            1,1,1,1,1,1,1,1,1,
            0,0,0,0,0,0,0,0,0,
            0,0,0,0,0,0,0,0,0,
            0,0,0,0,0,0,0,0,0,
            0,0,0,0,0,0,0,0,0,
            0,0,0,0,0,0,0,0,0,
            0,0,0,0,0,0,0,0,0,
            0,0,0,0,0,0,0,0,0,
            0,0,0,0,0,0,0,0,0
        ],
        "dropItems": [
            0,0,0,0,0,0,0,0,0,
            0,0,0,0,0,0,0,0,0,
            0,0,0,0,0,0,0,0,0,
            0,0,0,0,0,0,0,0,0,
            0,0,0,0,0,0,0,0,0,
            0,0,0,0,0,0,0,0,0,
            0,0,0,0,0,0,0,0,0,
            0,0,0,0,0,0,0,0,0,
            0,0,0,0,0,0,0,0,0
        ],
        "chains": [
            0,0,0,0,0,0,0,0,0,
            0,0,0,0,0,0,0,0,0,
            0,0,0,0,0,0,0,0,0,
            0,0,0,0,0,0,0,0,0,
            0,0,0,0,0,0,0,0,0,
            0,0,0,0,0,0,0,0,0,
            0,0,0,0,0,0,0,0,0,
            0,0,0,0,0,0,0,0,0,
            0,0,0,0,0,0,0,0,0
        ],
        "hiddenItems": [
            0,0,0,0,0,0,0,0,0,
            0,0,0,0,0,0,0,0,0,
            0,0,0,0,0,0,0,0,0,
            0,0,0,0,0,0,0,0,0,
            0,0,0,0,0,0,0,0,0,
            0,0,0,0,0,0,0,0,0,
            0,0,0,0,0,0,0,0,0,
            0,0,0,0,0,0,0,0,0,
            0,0,0,0,0,0,0,0,0
        ],
        "gemColors": [
            8,8,10,10,10,10,10,10,8,
            0,10,10,10,0,10,10,10,0,
            8,8,10,0,10,0,10,8,8,
            0,10,10,10,0,10,10,10,0,
            8,8,8,8,8,8,8,8,8,
            0,10,8,8,8,8,8,10,0,
            8,10,8,8,8,8,8,8,8,
            0,10,8,8,8,8,8,10,0,
            8,10,12,8,8,8,8,10,8
        ],
        "gemTypes": [
            6,7,0,0,0,0,0,0,6,
            0,0,0,0,0,0,0,0,0,
            6,1,0,0,0,0,0,7,6,
            0,0,0,0,0,0,0,0,0,
            6,7,0,0,0,0,0,1,6,
            0,0,0,0,0,0,0,0,0,
            6,0,0,0,0,0,0,7,6,
            0,0,0,0,0,0,0,0,0,
            6,0,0,0,0,0,0,0,6
        ],
        "gemModifier": [
            
        ],
        "portals": [
            0,0,0,0,0,0,0,0,0,
            0,0,0,0,0,0,0,0,0,
            0,0,0,0,0,0,0,0,0,
            0,0,0,0,0,0,0,0,0,
            0,0,0,0,0,0,0,0,0,
            0,0,0,0,0,0,0,0,0,
            0,0,0,0,0,0,0,0,0,
            0,0,0,0,0,0,0,0,0,
            0,0,0,0,0,0,0,0,0
        ],
        "crates": [
            0,3,0,0,0,0,0,3,0,
            0,0,0,0,0,0,0,0,0,
            1,2,0,0,0,0,0,2,1,
            0,0,0,0,0,0,0,0,0,
            0,3,0,0,0,0,0,3,0,
            0,0,0,0,0,0,0,0,0,
            1,2,0,0,0,0,0,2,1,
            0,0,0,0,0,0,0,0,0,
            0,3,0,0,0,0,0,3,0
        ],
        "climbers": [
            2,2,2,2,2,2,2,2,2,
            0,0,0,0,0,0,0,0,0,
            2,0,0,0,0,0,0,0,2,
            0,0,0,2,0,2,0,0,0,
            2,0,0,0,2,0,0,0,2,
            0,0,0,0,0,0,0,0,0,
            2,0,0,0,0,0,0,0,2,
            0,0,0,0,0,0,0,0,0,
            2,0,1,0,0,0,1,0,2
        ]
    },
    "collectable": ""
}
