{
    "data": {
        "moves": 35,
        "gems": [
            {
                "type": "coins",
                "amount": 25
            },
            {
                "type": "red",
                "amount": 25
            },
            {
                "type": "purple",
                "amount": 25
            },
            {
                "type": "yellow",
                "amount": 25
            },
            {
                "type": "blue",
                "amount": 13
            }
        ],
        "objectives": [
            
        ],
        "spawnRatioDroppable": {
            "gemColor": 0,
            "gemType": 0,
            "minSpawn": 0,
            "maxSpawn": 0,
            "probability": 0
        },
        "spawnRatios": [
            
        ],
        "hiddenItemName": "monkey"
    },
    "layout": {
        "fields": [
            1,1,1,1,1,1,1,1,1,
            1,1,1,1,1,1,1,1,1,
            1,1,1,1,1,1,1,1,1,
            1,1,1,1,1,1,1,1,1,
            1,1,1,0,2,2,0,1,1,
            1,1,1,0,1,1,0,1,1,
            1,1,1,0,1,1,0,2,2,
            1,1,1,0,1,1,0,1,1,
            1,1,1,0,1,1,0,1,1
        ],
        "tiles": [
            2,2,2,0,2,2,0,2,2,
            2,2,2,0,2,2,0,2,2,
            2,2,2,0,2,2,0,2,2,
            2,2,2,0,2,2,0,2,2,
            2,2,2,0,0,0,0,2,2,
            2,2,2,0,1,1,0,2,2,
            2,2,2,0,1,1,0,0,0,
            2,2,2,0,1,1,0,1,1,
            2,2,2,0,1,1,0,1,1
        ],
        "stones": [
            0,0,0,0,0,0,0,0,0,
            0,0,0,0,0,0,0,0,0,
            0,0,0,0,0,0,0,0,0,
            0,0,0,0,0,0,0,0,0,
            0,0,0,0,0,0,0,0,0,
            0,0,0,0,0,0,0,0,0,
            0,0,0,0,0,0,0,0,0,
            0,0,0,0,0,0,0,0,0,
            0,0,0,0,0,0,0,0,0
        ],
        "spawning": [
            1,1,1,1,1,1,1,1,1,
            0,0,0,0,0,0,0,0,0,
            0,0,0,0,0,0,0,0,0,
            0,0,0,0,0,0,0,0,0,
            0,0,0,0,0,0,0,0,0,
            0,0,0,0,0,0,0,0,0,
            0,0,0,0,0,0,0,0,0,
            0,0,0,0,0,0,0,0,0,
            0,0,0,0,0,0,0,0,0
        ],
        "dropItems": [
            0,0,0,0,0,0,0,0,0,
            0,0,0,0,0,0,0,0,0,
            0,0,0,0,0,0,0,0,0,
            0,0,0,0,0,0,0,0,0,
            0,0,0,0,0,0,0,0,0,
            0,0,0,0,0,0,0,0,0,
            0,0,0,0,0,0,0,0,0,
            0,0,0,0,0,0,0,0,0,
            0,0,0,0,0,0,0,0,0
        ],
        "chains": [
            0,0,0,0,0,0,0,0,0,
            0,0,0,0,0,0,0,0,0,
            0,0,0,0,0,0,0,0,0,
            0,0,0,0,0,0,0,0,0,
            0,0,0,0,0,0,0,0,0,
            0,0,0,0,0,0,0,0,0,
            0,0,0,0,0,0,0,0,0,
            0,0,0,0,0,0,0,0,0,
            0,0,0,0,0,0,0,0,0
        ],
        "hiddenItems": [
            0,0,0,0,7,7,0,5,5,
            0,0,0,0,7,7,0,5,5,
            6,6,6,0,0,0,0,0,0,
            6,6,6,0,0,0,0,8,8,
            6,6,6,0,0,0,0,8,8,
            0,0,0,0,3,3,0,0,0,
            4,4,4,0,3,3,0,0,0,
            4,4,4,0,2,2,0,1,1,
            4,4,4,0,2,2,0,1,1
        ],
        "gemColors": [
            10,10,10,8,8,8,8,8,8,
            10,10,10,8,8,8,8,8,8,
            10,10,10,8,8,8,8,8,8,
            10,10,10,8,8,8,8,8,8,
            10,10,10,0,0,0,0,8,8,
            10,10,10,0,10,10,0,8,8,
            9,10,10,0,10,10,0,0,0,
            10,10,10,0,10,10,0,10,10,
            10,10,9,0,10,10,0,10,10
        ],
        "gemTypes": [
            0,0,0,0,0,0,0,0,0,
            0,0,0,0,0,0,0,0,0,
            0,0,0,0,0,0,0,0,0,
            0,0,0,0,0,0,0,0,0,
            0,0,0,0,0,0,0,0,0,
            0,0,0,0,0,0,0,0,0,
            10,0,0,0,0,0,0,0,0,
            0,0,0,0,0,0,0,0,0,
            0,0,10,0,0,0,0,0,0
        ],
        "gemModifier": [
            0,0,0,0,0,0,0,0,0,
            0,0,0,0,0,0,0,0,0,
            0,0,0,0,0,0,0,0,0,
            0,0,0,0,0,0,0,0,0,
            0,0,0,0,0,0,0,0,0,
            0,0,0,0,0,0,0,0,0,
            8,0,0,0,0,0,0,0,0,
            0,0,0,0,0,0,0,0,0,
            0,0,7,0,0,0,0,0,0
        ],
        "portals": [
            0,0,0,0,0,0,0,0,0,
            0,0,0,0,0,0,0,0,0,
            0,0,0,0,0,0,0,0,0,
            0,0,0,0,0,0,0,0,0,
            0,0,0,0,0,0,0,0,0,
            0,0,0,0,0,0,0,0,0,
            0,0,0,0,0,0,0,0,0,
            0,0,0,0,0,0,0,0,0,
            0,0,0,0,0,0,0,0,0
        ],
        "crates": [
            0,0,0,0,0,0,0,0,0,
            0,0,0,0,0,0,0,0,0,
            0,0,0,0,0,0,0,0,0,
            0,0,0,0,0,0,0,0,0,
            0,0,0,0,0,0,0,0,0,
            0,0,0,0,0,0,0,0,0,
            0,0,0,0,0,0,0,0,0,
            0,0,0,0,0,0,0,0,0,
            0,0,0,0,0,0,0,0,0
        ],
        "climbers": [
            0,0,0,0,0,0,0,0,0,
            0,0,0,0,0,0,0,0,0,
            0,0,0,0,0,0,0,0,0,
            0,0,0,0,0,0,0,0,0,
            0,0,0,0,0,0,0,0,0,
            0,0,0,0,0,0,0,0,0,
            0,0,0,0,0,0,0,0,0,
            0,0,0,0,0,0,0,0,0,
            0,0,0,0,0,0,0,0,0
        ]
    },
    "collectable": ""
}
