{
    "data": {
        "moves": 38,
        "gems": [
            {
                "type": "coins",
                "amount": 25
            },
            {
                "type": "red",
                "amount": 25
            },
            {
                "type": "orange",
                "amount": 25
            },
            {
                "type": "yellow",
                "amount": 25
            },
            {
                "type": "purple",
                "amount": 4
            }
        ],
        "objectives": [
            {
                "type": "climber",
                "amount": 3
            }
        ],
        "spawnRatioDroppable": {
            "gemColor": 0,
            "gemType": 0,
            "minSpawn": 0,
            "maxSpawn": 0,
            "probability": 0
        },
        "spawnRatios": [
            {
                "gemColor": 8,
                "gemType": 6,
                "minSpawn": 0,
                "maxSpawn": 1,
                "probability": 3
            }
        ],
        "hiddenItemName": "monkey"
    },
    "layout": {
        "fields": [
            1,1,1,1,1,1,1,1,1,
            1,1,1,1,1,1,1,1,1,
            1,1,0,0,1,1,1,1,1,
            1,1,0,1,1,1,0,1,1,
            1,1,1,1,1,1,1,1,1,
            1,1,0,1,1,1,0,1,1,
            1,1,1,1,1,0,0,1,1,
            1,1,1,1,1,1,1,1,1,
            1,1,1,1,1,1,1,1,1
        ],
        "tiles": [
            0,0,0,0,0,0,0,0,0,
            0,0,0,0,0,0,0,0,0,
            0,0,0,0,0,0,0,0,0,
            0,0,0,0,0,0,0,0,0,
            0,0,0,0,0,0,0,0,0,
            0,0,0,0,0,0,0,0,0,
            0,0,0,0,0,0,0,0,0,
            0,0,0,0,0,0,0,0,0,
            0,0,0,0,0,0,0,0,0
        ],
        "stones": [
            0,0,0,0,0,0,0,0,0,
            0,0,0,0,0,0,0,0,0,
            0,0,0,0,0,0,0,0,0,
            0,0,0,0,0,0,0,0,0,
            0,0,0,0,0,0,0,0,0,
            0,0,0,0,0,0,0,0,0,
            0,0,0,0,0,0,0,0,0,
            0,0,0,0,0,0,0,0,0,
            0,0,0,0,0,0,0,0,0
        ],
        "spawning": [
            1,1,1,1,1,1,1,1,1,
            0,0,0,0,0,0,0,0,0,
            0,0,0,0,0,0,0,0,0,
            0,0,0,1,0,0,0,0,0,
            0,2,0,0,0,0,0,2,0,
            0,0,0,0,0,0,0,0,0,
            0,0,1,0,0,0,0,0,0,
            0,0,0,0,0,1,1,0,0,
            0,0,0,0,0,0,0,0,0
        ],
        "dropItems": [
            0,0,0,0,0,0,0,0,0,
            0,0,0,0,0,0,0,0,0,
            0,0,0,0,0,0,0,0,0,
            0,0,0,0,0,0,0,0,0,
            0,0,0,0,0,0,0,0,0,
            0,0,0,0,0,0,0,0,0,
            0,0,0,0,0,0,0,0,0,
            0,0,0,0,0,0,0,0,0,
            0,0,0,0,0,0,0,0,0
        ],
        "chains": [
            0,1,0,0,0,0,0,1,0,
            0,1,0,0,0,0,0,2,0,
            0,1,0,0,0,0,0,1,0,
            0,1,0,1,3,1,0,1,0,
            0,0,1,2,3,2,1,0,0,
            0,1,0,1,3,1,0,1,0,
            0,1,0,0,0,0,0,1,0,
            0,2,0,0,0,0,0,1,0,
            0,1,0,0,0,0,0,1,0
        ],
        "hiddenItems": [
            0,0,0,0,0,0,0,0,0,
            0,0,0,0,0,0,0,0,0,
            0,0,0,0,0,0,0,0,0,
            0,0,0,0,0,0,0,0,0,
            0,0,0,0,0,0,0,0,0,
            0,0,0,0,0,0,0,0,0,
            0,0,0,0,0,0,0,0,0,
            0,0,0,0,0,0,0,0,0,
            0,0,0,0,0,0,0,0,0
        ],
        "gemColors": [
            13,8,8,8,8,8,8,8,14,
            14,8,8,8,8,8,8,8,14,
            13,8,0,0,8,8,8,8,13,
            14,8,0,8,8,8,0,8,14,
            13,8,8,8,8,8,8,8,13,
            14,8,0,8,8,8,0,8,14,
            14,8,8,0,12,0,0,8,13,
            14,8,8,8,0,8,8,8,13,
            13,8,8,8,8,8,8,8,14
        ],
        "gemTypes": [
            0,6,0,0,0,0,0,6,0,
            0,6,0,0,0,0,0,6,0,
            0,0,0,0,0,0,0,6,0,
            0,6,0,1,0,0,0,0,0,
            0,6,0,6,0,6,0,6,0,
            0,0,0,0,0,1,0,6,0,
            0,6,0,0,0,0,0,0,0,
            0,6,0,0,0,0,0,6,0,
            0,6,0,0,0,0,0,6,0
        ],
        "gemModifier": [
            5,0,0,0,0,0,0,0,5,
            6,0,0,0,0,0,0,0,5,
            6,0,0,0,0,0,0,0,5,
            6,0,0,0,0,0,0,0,5,
            6,0,0,0,0,0,0,0,6,
            5,0,0,0,0,0,0,0,6,
            5,0,0,0,0,0,0,0,6,
            5,0,0,0,0,0,0,0,6,
            5,0,0,0,0,0,0,0,5
        ],
        "portals": [
            0,0,0,0,0,0,0,0,0,
            0,0,0,0,0,0,0,0,0,
            0,0,0,0,0,0,0,0,0,
            0,0,0,0,0,0,0,0,0,
            0,0,0,0,0,0,0,0,0,
            0,0,0,0,0,0,0,0,0,
            0,0,0,0,0,0,0,0,0,
            0,0,0,0,0,0,0,0,0,
            0,0,0,0,0,0,0,0,0
        ],
        "crates": [
            0,0,0,0,0,0,0,0,0,
            0,0,0,0,0,0,0,0,0,
            0,0,0,0,0,0,0,0,0,
            0,0,0,0,0,0,0,0,0,
            0,0,0,0,0,0,0,0,0,
            0,0,0,0,0,0,0,0,0,
            0,0,0,0,0,0,0,0,0,
            0,0,0,0,0,0,0,0,0,
            0,0,0,0,0,0,0,0,0
        ],
        "climbers": [
            2,2,0,2,2,2,0,2,2,
            0,0,0,0,0,0,0,0,0,
            0,0,0,0,0,0,0,0,0,
            0,0,0,2,0,0,0,0,0,
            0,0,2,0,0,0,2,0,0,
            0,0,0,0,0,0,0,0,0,
            0,0,2,0,0,0,0,0,0,
            0,0,0,0,0,2,2,0,0,
            1,0,0,0,1,0,0,0,1
        ]
    },
    "collectable": ""
}
