{
    "data": {
        "moves": 30,
        "gems": [
            {
                "type": "coins",
                "amount": 25
            },
            {
                "type": "yellow",
                "amount": 25
            },
            {
                "type": "green",
                "amount": 25
            },
            {
                "type": "red",
                "amount": 25
            },
            {
                "type": "purple",
                "amount": 25
            },
            {
                "type": "orange",
                "amount": 2
            }
        ],
        "objectives": [
            
        ],
        "spawnRatioDroppable": {
            "gemColor": 0,
            "gemType": 0,
            "minSpawn": 0,
            "maxSpawn": 0,
            "probability": 0
        },
        "spawnRatios": [
            
        ],
        "hiddenItemName": "monkey"
    },
    "layout": {
        "fields": [
            1,1,0,1,1,1,0,1,1,
            1,1,1,1,1,1,1,1,1,
            1,1,1,1,0,1,1,1,1,
            0,1,1,0,0,0,1,1,0,
            1,0,1,1,1,1,1,0,1,
            1,1,1,1,1,1,1,1,1,
            1,1,1,1,1,1,1,1,1,
            1,1,1,1,1,1,1,1,1,
            1,1,1,1,1,1,1,1,1
        ],
        "tiles": [
            2,2,0,2,2,2,0,2,2,
            2,2,2,2,2,2,2,2,2,
            2,2,2,2,0,2,2,2,2,
            0,2,2,0,0,0,2,2,0,
            0,0,0,2,2,2,0,0,0,
            0,0,0,2,2,2,0,0,0,
            2,2,0,2,2,2,0,2,2,
            2,2,2,0,0,0,2,2,2,
            2,2,2,0,0,0,2,2,2
        ],
        "stones": [
            0,0,0,0,0,0,0,0,0,
            0,0,0,0,0,0,0,0,0,
            0,0,0,0,0,0,0,0,0,
            0,3,4,0,0,0,4,3,0,
            0,0,0,0,0,0,0,0,0,
            0,0,0,0,0,0,0,0,0,
            0,0,3,0,0,0,3,0,0,
            0,0,0,0,0,0,0,0,0,
            0,0,0,0,0,0,0,0,0
        ],
        "spawning": [
            1,1,0,1,1,1,0,1,1,
            0,0,0,0,0,0,0,0,0,
            0,0,0,0,0,0,0,0,0,
            0,0,0,0,0,0,0,0,0,
            1,0,0,1,1,1,0,0,1,
            0,0,0,0,0,0,0,0,0,
            0,0,0,0,0,0,0,0,0,
            0,0,0,0,0,0,0,0,0,
            0,0,0,0,0,0,0,0,0
        ],
        "dropItems": [
            0,0,0,0,0,0,0,0,0,
            0,0,0,0,0,0,0,0,0,
            0,0,0,0,0,0,0,0,0,
            0,0,0,0,0,0,0,0,0,
            0,0,0,0,0,0,0,0,0,
            0,0,0,0,0,0,0,0,0,
            0,0,0,0,0,0,0,0,0,
            0,0,0,0,0,0,0,0,0,
            0,0,0,0,0,0,0,0,0
        ],
        "chains": [
            0,0,0,0,0,0,0,0,0,
            0,0,0,0,0,0,0,0,0,
            0,0,0,0,0,0,0,0,0,
            0,0,0,0,0,0,0,0,0,
            0,0,0,0,0,0,0,0,0,
            0,0,0,0,0,0,0,0,0,
            0,0,0,0,0,0,0,0,0,
            0,0,0,0,0,0,0,0,0,
            0,0,0,0,0,0,0,0,0
        ],
        "hiddenItems": [
            3,3,0,0,7,7,0,4,4,
            3,3,0,0,7,7,0,4,4,
            0,0,0,0,0,0,0,0,0,
            0,0,0,0,0,0,0,0,0,
            0,0,0,1,1,1,0,0,0,
            0,0,0,1,1,1,0,0,0,
            0,0,0,1,1,1,0,0,0,
            8,8,0,0,0,0,0,2,2,
            8,8,0,0,0,0,0,2,2
        ],
        "gemColors": [
            2,8,0,8,2,8,0,8,2,
            8,2,8,2,4,2,8,2,8,
            8,4,8,4,0,4,8,4,8,
            0,0,0,0,0,0,0,0,0,
            2,0,0,8,2,8,0,0,2,
            8,8,8,8,8,8,8,8,8,
            8,8,0,8,2,8,0,8,8,
            8,8,8,8,8,8,8,8,8,
            4,8,2,8,2,8,2,8,4
        ],
        "gemTypes": [
            0,0,0,0,0,0,0,0,0,
            0,0,0,0,2,0,0,0,0,
            0,2,0,2,0,2,0,2,0,
            0,0,0,0,0,0,0,0,0,
            8,0,0,0,8,0,0,0,8,
            0,0,0,0,0,0,0,0,0,
            0,0,0,0,8,0,0,0,0,
            0,0,0,0,0,0,0,0,0,
            2,0,10,0,7,0,10,0,2
        ],
        "gemModifier": [
            1,2,0,2,1,2,0,2,1,
            1,1,3,1,1,1,3,1,1,
            0,1,3,1,0,1,3,1,0,
            0,0,0,0,0,0,0,0,0,
            2,0,0,0,3,0,0,0,2,
            0,0,0,0,1,0,0,0,0,
            0,0,0,0,2,0,0,0,0,
            0,0,0,0,1,0,0,0,0,
            1,0,8,0,2,0,8,0,1
        ],
        "portals": [
            0,0,0,0,0,0,0,0,0,
            0,0,0,0,0,0,0,0,0,
            0,0,0,0,0,0,0,0,0,
            0,0,0,0,0,0,0,0,0,
            0,0,0,0,0,0,0,0,0,
            0,0,0,0,0,0,0,0,0,
            0,0,0,0,0,0,0,0,0,
            0,0,0,0,0,0,0,0,0,
            0,0,0,0,0,0,0,0,0
        ],
        "crates": [
            0,0,0,0,0,0,0,0,0,
            0,0,0,0,0,0,0,0,0,
            0,0,0,0,0,0,0,0,0,
            0,0,0,0,0,0,0,0,0,
            0,0,0,0,0,0,0,0,0,
            0,0,0,0,0,0,0,0,0,
            0,0,0,0,0,0,0,0,0,
            0,0,0,0,0,0,0,0,0,
            0,0,0,0,0,0,0,0,0
        ],
        "climbers": [
            0,0,0,0,0,0,0,0,0,
            0,0,0,0,0,0,0,0,0,
            0,0,0,0,0,0,0,0,0,
            0,0,0,0,0,0,0,0,0,
            0,0,0,0,0,0,0,0,0,
            0,0,0,0,0,0,0,0,0,
            0,0,0,0,0,0,0,0,0,
            0,0,0,0,0,0,0,0,0,
            0,0,0,0,0,0,0,0,0
        ]
    },
    "collectable": ""
}
