{
    "data": {
        "moves": 38,
        "gems": [
            {
                "type": "coins",
                "amount": 25
            },
            {
                "type": "purple",
                "amount": 25
            },
            {
                "type": "green",
                "amount": 25
            },
            {
                "type": "blue",
                "amount": 25
            },
            {
                "type": "red",
                "amount": 25
            }
        ],
        "objectives": [
            {
                "type": "yellow",
                "amount": 40
            }
        ],
        "spawnRatioDroppable": {
            "gemColor": 0,
            "gemType": 0,
            "minSpawn": 0,
            "maxSpawn": 0,
            "probability": 0
        },
        "spawnRatios": [
            {
                "gemColor": 4,
                "gemType": 7,
                "minSpawn": 1,
                "maxSpawn": 3,
                "probability": 2
            }
        ],
        "hiddenItemName": "monkey"
    },
    "layout": {
        "fields": [
            1,1,1,1,0,1,1,1,1,
            1,1,1,1,0,1,1,1,1,
            1,1,1,1,0,1,1,1,1,
            1,1,1,1,0,1,1,1,1,
            1,1,1,1,0,1,1,1,0,
            1,1,1,1,0,1,1,1,1,
            1,1,1,1,0,1,1,1,1,
            1,1,1,1,0,1,1,1,1,
            1,1,1,1,0,1,1,1,1
        ],
        "tiles": [
            1,1,1,1,0,0,0,0,0,
            1,1,1,1,0,0,0,0,0,
            1,1,1,1,0,0,0,0,0,
            1,1,1,1,0,0,0,0,0,
            1,1,1,1,0,1,1,1,0,
            1,1,1,1,0,1,1,1,1,
            1,1,1,1,0,1,1,1,1,
            1,1,1,1,0,1,1,1,1,
            1,1,1,1,0,1,1,1,1
        ],
        "stones": [
            0,0,0,0,0,0,0,0,0,
            0,0,0,0,0,0,0,0,0,
            0,0,0,0,0,0,0,0,0,
            0,0,0,0,0,0,0,0,0,
            0,0,0,0,0,0,0,0,0,
            0,0,0,0,0,0,0,0,0,
            0,0,0,0,0,0,0,0,0,
            0,0,0,0,0,0,0,0,0,
            0,0,0,0,0,0,0,0,0
        ],
        "spawning": [
            1,1,1,1,0,0,0,0,0,
            0,0,0,0,0,0,0,0,0,
            0,0,0,0,0,0,0,0,0,
            0,0,0,0,0,0,0,0,0,
            0,0,0,0,0,0,0,0,0,
            0,0,0,0,0,0,0,0,0,
            0,0,0,0,0,0,0,0,0,
            0,0,0,0,0,0,0,0,0,
            0,0,0,0,0,0,0,0,0
        ],
        "dropItems": [
            0,0,0,0,0,0,0,0,0,
            0,0,0,0,0,0,0,0,0,
            0,0,0,0,0,0,0,0,0,
            0,0,0,0,0,0,0,0,0,
            0,0,0,0,0,0,0,0,0,
            0,0,0,0,0,0,0,0,0,
            0,0,0,0,0,0,0,0,0,
            0,0,0,0,0,0,0,0,0,
            0,0,0,0,0,0,0,0,0
        ],
        "chains": [
            0,0,0,0,0,0,0,0,0,
            1,0,1,0,0,0,0,0,0,
            1,0,1,0,0,0,0,0,0,
            0,1,0,1,0,0,0,0,0,
            0,2,0,2,0,0,0,0,0,
            0,1,0,1,0,0,0,0,0,
            1,0,1,0,0,1,2,2,2,
            1,0,1,0,0,2,1,2,1,
            0,0,0,0,0,2,2,1,2
        ],
        "hiddenItems": [
            6,6,0,0,0,0,0,0,0,
            6,6,0,0,0,0,0,0,0,
            0,5,5,5,0,0,0,0,0,
            0,5,5,5,0,0,0,0,0,
            0,5,5,5,0,8,8,0,0,
            1,1,1,1,0,8,8,0,0,
            1,1,1,1,0,0,7,7,7,
            1,1,1,1,0,0,7,7,7,
            1,1,1,1,0,0,7,7,7
        ],
        "gemColors": [
            8,8,8,8,0,8,8,8,8,
            4,8,4,8,0,8,8,8,8,
            8,8,8,8,0,8,8,8,8,
            8,8,8,8,0,8,8,8,8,
            8,4,8,4,0,8,8,8,0,
            8,8,8,8,0,8,8,8,8,
            8,8,8,8,0,8,4,8,4,
            4,8,4,8,0,4,8,4,8,
            8,8,8,8,0,8,4,8,4
        ],
        "gemTypes": [
            0,0,0,0,0,0,0,0,0,
            7,0,7,0,0,0,0,0,0,
            0,0,0,0,0,0,0,0,0,
            0,0,0,0,0,0,0,0,0,
            0,7,0,7,0,0,0,0,0,
            0,0,0,0,0,0,0,0,0,
            0,0,0,0,0,0,7,0,7,
            7,0,7,0,0,7,0,7,0,
            0,0,0,0,0,0,7,0,7
        ],
        "gemModifier": [
            0,0,0,0,0,0,0,0,0,
            0,0,0,0,0,0,0,0,0,
            0,0,0,0,0,0,0,0,0,
            0,0,0,0,0,0,0,0,0,
            0,0,0,0,0,0,0,0,0,
            0,0,0,0,0,0,0,0,0,
            0,0,0,0,0,0,0,0,0,
            0,0,0,0,0,0,0,0,0,
            0,0,0,0,0,0,0,0,0
        ],
        "gemDirection": [
            0,0,0,0,0,0,0,0,0,
            0,0,0,0,0,0,0,0,0,
            0,0,0,0,0,0,0,0,0,
            0,0,0,0,0,0,0,0,0,
            0,0,0,0,0,0,0,0,0,
            0,0,0,0,0,0,0,0,0,
            0,0,0,0,0,0,0,0,0,
            0,0,0,0,0,0,0,0,0,
            0,0,0,0,0,0,0,0,0
        ],
        "portals": [
            0,0,0,0,0,2,4,6,8,
            0,0,0,0,0,0,0,0,0,
            0,0,0,0,0,0,0,0,0,
            0,0,0,0,0,0,0,0,0,
            0,0,0,0,0,0,0,0,0,
            0,0,0,0,0,0,0,0,0,
            0,0,0,0,0,0,0,0,0,
            0,0,0,0,0,0,0,0,0,
            1,3,5,7,0,0,0,0,0
        ],
        "crates": [
            0,0,0,0,0,0,0,0,0,
            0,0,0,0,0,0,0,0,0,
            0,0,0,0,0,0,0,0,0,
            0,0,0,0,0,0,0,0,0,
            0,0,0,0,0,0,0,0,0,
            0,0,0,0,0,0,0,0,0,
            0,0,0,0,0,0,0,0,0,
            0,0,0,0,0,0,0,0,0,
            0,0,0,0,0,0,0,0,0
        ],
        "climbers": [
            0,0,0,0,0,0,0,0,0,
            0,0,0,0,0,0,0,0,0,
            0,0,0,0,0,0,0,0,0,
            0,0,0,0,0,0,0,0,0,
            0,0,0,0,0,0,0,0,0,
            0,0,0,0,0,0,0,0,0,
            0,0,0,0,0,0,0,0,0,
            0,0,0,0,0,0,0,0,0,
            0,0,0,0,0,0,0,0,0
        ]
    },
    "collectable": ""
}
