{
    "data": {
        "moves": 28,
        "gems": [
            {
                "type": "coins",
                "amount": 25
            },
            {
                "type": "red",
                "amount": 25
            },
            {
                "type": "purple",
                "amount": 25
            },
            {
                "type": "blue",
                "amount": 25
            },
            {
                "type": "green",
                "amount": 21
            }
        ],
        "objectives": [
            {
                "type": "climber",
                "amount": 3
            }
        ],
        "spawnRatioDroppable": {
            "gemColor": 0,
            "gemType": 0,
            "minSpawn": 0,
            "maxSpawn": 0,
            "probability": 0
        },
        "spawnRatios": [
            {
                "gemColor": 8,
                "gemType": 6,
                "minSpawn": 2,
                "maxSpawn": 5,
                "probability": 3
            }
        ],
        "hiddenItemName": "monkey"
    },
    "layout": {
        "fields": [
            1,1,1,1,0,1,0,1,1,
            1,1,1,1,0,1,0,1,1,
            1,1,1,1,0,1,0,1,1,
            1,1,1,1,0,1,0,1,1,
            1,1,1,1,0,1,0,1,1,
            1,1,1,1,0,1,0,1,1,
            1,1,1,1,0,1,0,1,1,
            1,1,1,1,1,1,1,1,1,
            1,1,1,1,1,1,1,1,1
        ],
        "tiles": [
            0,0,0,0,0,0,0,0,0,
            0,0,0,0,0,0,0,0,0,
            0,0,0,0,0,0,0,0,0,
            0,0,0,0,0,0,0,0,0,
            0,0,0,0,0,0,0,0,0,
            0,0,0,0,0,0,0,0,0,
            0,0,0,0,0,0,0,0,0,
            0,0,0,0,0,0,0,0,0,
            0,0,0,0,0,0,0,0,0
        ],
        "stones": [
            2,2,0,2,0,0,0,2,0,
            2,0,0,0,0,0,0,0,2,
            2,2,0,2,0,0,0,2,0,
            2,0,2,0,0,0,0,0,2,
            0,1,0,1,0,0,0,2,0,
            0,0,0,0,0,0,0,0,3,
            0,0,0,0,0,0,0,3,0,
            0,0,0,0,2,0,2,0,3,
            0,0,0,0,1,2,1,3,3
        ],
        "spawning": [
            1,1,1,1,0,1,0,1,1,
            0,0,2,0,0,0,0,0,0,
            0,0,0,0,0,0,0,0,0,
            0,0,0,0,0,0,0,0,0,
            0,0,0,0,0,0,0,0,0,
            0,0,0,0,0,0,0,0,0,
            0,0,0,0,0,0,0,0,0,
            0,0,2,0,1,0,1,0,0,
            0,0,0,0,0,0,0,0,0
        ],
        "dropItems": [
            0,0,0,0,0,0,0,0,0,
            0,0,0,0,0,0,0,0,0,
            0,0,0,0,0,0,0,0,0,
            0,0,0,0,0,0,0,0,0,
            0,0,0,0,0,0,0,0,0,
            0,0,0,0,0,0,0,0,0,
            0,0,0,0,0,0,0,0,0,
            0,0,0,0,0,0,0,0,0,
            0,0,0,0,0,0,0,0,0
        ],
        "chains": [
            0,0,0,0,0,2,0,0,0,
            0,0,0,0,0,2,0,0,0,
            0,0,0,0,0,2,0,0,0,
            0,0,0,0,0,2,0,0,0,
            0,0,0,0,0,2,0,0,0,
            0,0,0,0,0,2,0,0,0,
            0,0,0,0,0,2,0,0,0,
            0,0,0,0,0,0,0,0,0,
            0,0,0,0,0,0,0,0,0
        ],
        "hiddenItems": [
            0,0,0,0,0,0,0,0,0,
            0,0,0,0,0,0,0,0,0,
            0,0,0,0,0,0,0,0,0,
            0,0,0,0,0,0,0,0,0,
            0,0,0,0,0,0,0,0,0,
            0,0,0,0,0,0,0,0,0,
            0,0,0,0,0,0,0,0,0,
            0,0,0,0,0,0,0,0,0,
            0,0,0,0,0,0,0,0,0
        ],
        "gemColors": [
            0,0,8,0,0,10,0,0,8,
            0,8,9,8,0,10,0,8,0,
            0,0,8,0,0,10,0,0,8,
            0,8,0,8,0,10,0,8,0,
            8,0,8,0,0,10,0,0,8,
            8,8,8,8,0,10,0,8,0,
            8,8,8,9,0,10,0,0,8,
            8,9,9,8,0,12,0,8,0,
            8,8,8,8,0,0,0,0,0
        ],
        "gemTypes": [
            0,0,0,0,0,0,0,0,6,
            0,0,2,0,0,0,0,6,0,
            0,0,0,0,0,0,0,0,6,
            0,0,0,0,0,0,0,6,0,
            0,0,0,0,0,0,0,0,6,
            0,0,0,0,0,0,0,6,0,
            0,0,0,0,0,0,0,0,6,
            0,0,1,0,0,0,0,6,0,
            0,0,0,0,0,0,0,0,0
        ],
        "gemModifier": [
            0,0,0,0,0,0,0,0,0,
            0,0,0,0,0,0,0,0,0,
            0,0,0,0,0,0,0,0,0,
            0,0,0,0,0,0,0,0,0,
            0,0,0,0,0,0,0,0,0,
            0,0,0,0,0,0,0,0,0,
            0,0,0,0,0,0,0,0,0,
            0,0,0,0,0,0,0,0,0,
            0,0,0,0,0,0,0,0,0
        ],
        "portals": [
            0,0,0,0,0,0,0,0,0,
            0,0,0,0,0,0,0,0,0,
            0,0,0,0,0,0,0,0,0,
            0,0,0,0,0,0,0,0,0,
            0,0,0,0,0,0,0,0,0,
            0,0,0,0,0,0,0,0,0,
            0,0,0,0,0,0,0,0,0,
            0,0,0,0,0,0,0,0,0,
            0,0,0,0,0,0,0,0,0
        ],
        "crates": [
            0,0,0,0,0,0,0,0,0,
            0,0,0,0,0,0,0,0,0,
            0,0,0,0,0,0,0,0,0,
            0,0,0,0,0,0,0,0,0,
            0,0,0,0,0,0,0,0,0,
            0,0,0,0,0,0,0,0,0,
            0,0,0,0,0,0,0,0,0,
            0,0,0,0,0,0,0,0,0,
            0,0,0,0,0,0,0,0,0
        ],
        "climbers": [
            2,2,2,2,0,2,0,2,2,
            0,0,0,0,0,0,0,0,0,
            0,0,0,0,0,0,0,0,0,
            0,0,0,0,0,0,0,0,0,
            0,0,0,0,0,0,0,0,0,
            0,0,0,0,0,0,0,0,0,
            0,0,0,0,0,0,0,0,0,
            0,0,0,0,0,0,2,0,0,
            0,0,0,0,0,0,0,1,1
        ]
    },
    "collectable": ""
}
