{
    "data": {
        "moves": 27,
        "gems": [
            {
                "type": "coins",
                "amount": 25
            },
            {
                "type": "green",
                "amount": 25
            },
            {
                "type": "orange",
                "amount": 25
            },
            {
                "type": "red",
                "amount": 25
            },
            {
                "type": "yellow",
                "amount": 6
            }
        ],
        "objectives": [
            {
                "type": "droppable",
                "amount": 2
            }
        ],
        "spawnRatioDroppable": {
            "gemColor": 7,
            "gemType": 0,
            "minSpawn": 1,
            "maxSpawn": 1,
            "probability": 5
        },
        "spawnRatios": [
            {
                "gemColor": 10,
                "gemType": 0,
                "minSpawn": 0,
                "maxSpawn": 6,
                "probability": 8
            }
        ],
        "hiddenItemName": "monkey"
    },
    "layout": {
        "fields": [
            1,1,1,0,1,1,1,1,1,
            1,1,1,0,1,1,1,0,1,
            1,1,1,0,1,1,1,1,1,
            1,1,1,1,1,1,1,0,1,
            1,1,1,1,1,1,1,1,1,
            1,1,1,1,1,1,1,0,1,
            1,1,1,0,1,1,1,1,1,
            1,1,1,0,1,1,1,0,1,
            1,1,1,0,1,1,1,1,1
        ],
        "tiles": [
            0,0,0,0,0,0,0,0,0,
            0,0,0,0,0,0,0,0,0,
            0,0,0,0,0,0,0,0,0,
            0,0,0,0,0,0,0,0,0,
            0,0,0,0,0,0,0,0,0,
            0,0,0,0,0,0,0,0,0,
            0,0,0,0,0,0,0,0,0,
            0,0,0,0,0,0,0,0,0,
            0,0,0,0,0,0,0,0,0
        ],
        "stones": [
            0,0,0,0,0,0,0,0,0,
            0,0,0,0,0,0,0,0,0,
            0,0,0,0,0,0,0,0,0,
            0,0,0,0,0,0,0,0,0,
            0,0,0,0,0,0,0,0,0,
            0,0,0,0,0,0,0,0,0,
            0,0,0,0,0,0,0,0,0,
            0,0,0,0,0,0,0,0,0,
            0,0,0,0,0,0,0,0,0
        ],
        "spawning": [
            1,1,1,0,1,1,1,2,0,
            0,0,0,0,0,0,0,0,0,
            0,0,0,0,0,0,0,1,0,
            0,0,0,1,0,0,0,0,0,
            0,0,0,0,0,0,0,1,0,
            0,0,0,0,0,0,0,0,0,
            0,0,0,0,0,0,0,1,0,
            2,0,0,0,0,0,0,0,0,
            0,0,0,0,0,0,0,2,0
        ],
        "dropItems": [
            0,0,0,0,0,0,0,0,1,
            0,0,0,0,0,0,0,0,0,
            0,0,0,0,0,0,0,0,0,
            0,0,0,0,0,0,0,0,0,
            0,0,0,0,0,0,0,0,0,
            0,0,0,0,0,0,0,0,0,
            0,0,0,0,0,0,0,0,0,
            0,0,0,0,0,0,0,0,0,
            0,0,0,0,2,2,2,0,2
        ],
        "chains": [
            0,0,0,0,0,0,0,0,0,
            0,0,0,0,0,0,0,0,0,
            0,0,0,0,0,0,0,0,0,
            0,0,0,0,0,0,0,0,0,
            0,0,0,0,0,0,0,0,0,
            0,0,0,0,0,0,0,0,0,
            0,0,0,0,0,0,0,0,0,
            0,0,0,0,0,0,0,0,0,
            0,0,0,0,0,0,0,0,0
        ],
        "hiddenItems": [
            0,0,0,0,0,0,0,0,0,
            0,0,0,0,0,0,0,0,0,
            0,0,0,0,0,0,0,0,0,
            0,0,0,0,0,0,0,0,0,
            0,0,0,0,0,0,0,0,0,
            0,0,0,0,0,0,0,0,0,
            0,0,0,0,0,0,0,0,0,
            0,0,0,0,0,0,0,0,0,
            0,0,0,0,0,0,0,0,0
        ],
        "gemColors": [
            10,8,8,0,8,8,10,8,7,
            10,8,8,0,8,8,10,0,10,
            8,8,8,0,8,8,10,10,8,
            10,8,8,10,8,8,10,0,10,
            10,8,8,10,8,8,10,10,10,
            8,8,8,10,8,8,10,0,10,
            10,8,8,0,8,8,10,10,8,
            8,8,8,0,8,8,10,0,10,
            10,8,8,0,8,8,10,8,10
        ],
        "gemTypes": [
            0,0,0,0,0,0,0,2,0,
            0,0,0,0,0,0,0,0,0,
            1,0,0,0,0,0,0,0,0,
            0,0,0,0,0,0,0,0,0,
            0,0,0,0,0,0,0,0,0,
            2,0,0,0,0,0,0,0,0,
            0,0,0,0,0,0,0,0,0,
            1,0,0,0,0,0,0,0,0,
            0,0,0,0,0,0,0,1,0
        ],
        "gemModifier": [
            0,0,0,0,0,0,0,0,0,
            0,0,0,0,0,0,0,0,0,
            0,0,0,0,0,0,0,0,0,
            0,0,0,0,0,0,0,0,0,
            0,0,0,0,0,0,0,0,0,
            0,0,0,0,0,0,0,0,0,
            0,0,0,0,0,0,0,0,0,
            0,0,0,0,0,0,0,0,0,
            0,0,0,0,0,0,0,0,0
        ],
        "portals": [
            0,0,0,0,0,0,0,0,0,
            0,0,0,0,0,0,0,0,0,
            0,0,0,0,0,0,0,0,0,
            0,0,0,0,0,0,0,0,0,
            0,0,0,0,0,0,0,0,0,
            0,0,0,0,0,0,0,0,0,
            0,0,0,0,0,0,0,0,0,
            0,0,0,0,0,0,0,0,0,
            0,0,0,0,0,0,0,0,0
        ],
        "crates": [
            10,0,0,0,0,0,0,0,0,
            10,0,0,0,0,0,0,0,0,
            10,0,0,0,0,0,0,0,0,
            10,0,0,0,0,0,0,0,0,
            10,0,0,0,0,0,0,0,0,
            10,0,0,0,0,0,0,0,0,
            10,0,0,0,0,0,0,0,0,
            10,0,0,0,0,0,0,0,0,
            10,0,0,0,0,0,0,0,0
        ],
        "climbers": [
            0,0,0,0,0,0,0,0,0,
            0,0,0,0,0,0,0,0,0,
            0,0,0,0,0,0,0,0,0,
            0,0,0,0,0,0,0,0,0,
            0,0,0,0,0,0,0,0,0,
            0,0,0,0,0,0,0,0,0,
            0,0,0,0,0,0,0,0,0,
            0,0,0,0,0,0,0,0,0,
            0,0,0,0,0,0,0,0,0
        ]
    },
    "collectable": ""
}
