{
    "data": {
        "moves": 32,
        "gems": [
            {
                "type": "coins",
                "amount": 25
            },
            {
                "type": "red",
                "amount": 25
            },
            {
                "type": "orange",
                "amount": 25
            },
            {
                "type": "yellow",
                "amount": 25
            },
            {
                "type": "blue",
                "amount": 8
            }
        ],
        "objectives": [
            
        ],
        "spawnRatioDroppable": {
            "gemColor": 0,
            "gemType": 0,
            "minSpawn": 0,
            "maxSpawn": 0,
            "probability": 0
        },
        "spawnRatios": [
            
        ],
        "hiddenItemName": "monkey"
    },
    "layout": {
        "fields": [
            1,1,1,1,1,1,1,1,1,
            1,1,1,1,1,1,1,1,1,
            1,1,0,1,1,0,1,1,0,
            0,1,1,1,1,1,1,1,1,
            1,1,1,1,1,1,1,1,1,
            1,1,1,1,1,1,1,1,0,
            0,1,1,0,1,1,0,1,1,
            1,1,1,1,1,1,1,1,1,
            1,1,1,1,1,1,1,1,1
        ],
        "tiles": [
            0,0,0,0,0,0,0,0,0,
            0,0,0,0,0,0,0,0,0,
            0,0,0,0,0,0,0,0,0,
            0,2,2,1,1,1,2,2,2,
            1,1,1,1,1,1,1,1,1,
            2,2,2,1,1,1,2,2,0,
            0,2,2,0,2,2,0,1,1,
            0,2,2,0,2,2,0,1,1,
            0,2,2,0,2,2,0,1,1
        ],
        "stones": [
            0,0,0,0,0,0,0,0,0,
            0,0,0,0,0,0,0,0,0,
            0,0,0,0,0,0,0,0,0,
            0,0,0,0,0,0,0,0,0,
            0,0,0,0,0,0,0,0,0,
            0,0,0,0,0,0,0,0,0,
            0,0,0,0,0,0,0,0,0,
            0,0,0,0,0,0,0,0,0,
            0,0,0,0,0,0,0,0,0
        ],
        "spawning": [
            1,1,1,1,1,1,1,1,1,
            0,0,0,0,0,0,0,0,0,
            0,0,0,0,0,0,0,0,0,
            0,0,1,0,0,1,0,0,1,
            0,0,0,0,0,0,0,0,0,
            0,0,0,0,0,0,0,0,0,
            0,0,0,0,0,0,0,0,0,
            0,0,0,1,0,0,1,0,0,
            0,0,0,0,0,0,0,0,0
        ],
        "dropItems": [
            0,0,0,0,0,0,0,0,0,
            0,0,0,0,0,0,0,0,0,
            0,0,0,0,0,0,0,0,0,
            0,0,0,0,0,0,0,0,0,
            0,0,0,0,0,0,0,0,0,
            0,0,0,0,0,0,0,0,0,
            0,0,0,0,0,0,0,0,0,
            0,0,0,0,0,0,0,0,0,
            0,0,0,0,0,0,0,0,0
        ],
        "chains": [
            0,0,0,0,0,0,0,0,0,
            0,0,0,0,0,0,0,0,0,
            0,0,0,0,0,0,0,0,0,
            0,0,0,0,0,0,0,0,0,
            0,0,0,0,0,0,0,0,0,
            0,0,0,0,0,0,0,0,0,
            0,0,0,0,0,0,0,0,0,
            0,0,0,0,0,0,0,0,0,
            0,0,0,0,0,0,0,0,0
        ],
        "hiddenItems": [
            0,0,0,0,0,0,0,0,0,
            0,0,0,0,0,0,0,0,0,
            0,0,0,0,0,0,0,0,0,
            0,0,5,5,5,0,0,1,1,
            2,2,5,5,5,7,7,1,1,
            2,2,5,5,5,7,7,0,0,
            0,0,0,0,0,0,0,0,0,
            0,8,8,0,6,6,0,3,3,
            0,8,8,0,6,6,0,3,3
        ],
        "gemColors": [
            13,14,3,13,14,3,13,14,3,
            13,13,3,13,13,3,14,13,3,
            9,1,0,1,6,0,4,9,0,
            0,0,8,0,0,8,0,0,8,
            8,8,8,8,8,8,8,8,8,
            8,8,8,8,8,8,8,8,0,
            0,8,8,0,8,8,0,8,14,
            14,8,8,8,8,8,8,8,13,
            13,8,8,8,8,8,8,8,13
        ],
        "gemTypes": [
            0,0,0,0,0,0,0,0,0,
            0,0,0,0,0,0,0,0,0,
            10,10,0,10,10,0,10,10,0,
            0,0,0,0,0,0,0,0,0,
            0,0,0,0,0,0,0,0,0,
            0,0,0,0,0,0,0,0,0,
            0,0,0,0,0,0,0,0,0,
            0,0,0,0,0,0,0,0,0,
            0,0,0,0,0,0,0,0,0
        ],
        "gemModifier": [
            5,6,0,6,5,0,5,6,0,
            6,5,0,5,6,0,6,5,0,
            8,7,0,8,8,0,8,7,0,
            0,0,0,0,0,0,0,0,0,
            0,0,0,0,0,0,0,0,0,
            0,0,0,0,0,0,0,0,0,
            0,0,0,0,0,0,0,0,6,
            6,0,0,0,0,0,0,0,6,
            6,0,0,0,0,0,0,0,6
        ],
        "portals": [
            0,0,0,0,0,0,0,0,0,
            0,0,0,0,0,0,0,0,0,
            0,0,0,0,0,0,0,0,0,
            0,0,0,0,0,0,0,0,0,
            0,0,0,0,0,0,0,0,0,
            0,0,0,0,0,0,0,0,0,
            0,0,0,0,0,0,0,0,0,
            0,0,0,0,0,0,0,0,0,
            0,0,0,0,0,0,0,0,0
        ],
        "crates": [
            0,0,0,0,0,0,0,0,0,
            0,0,0,0,0,0,0,0,0,
            1,1,0,1,0,0,1,1,0,
            0,0,0,0,0,0,0,0,0,
            0,0,0,0,0,0,0,0,0,
            0,0,0,0,0,0,0,0,0,
            0,1,0,0,0,0,0,1,0,
            0,1,0,0,0,0,0,1,0,
            0,1,0,0,0,0,0,1,0
        ],
        "climbers": [
            0,0,0,0,0,0,0,0,0,
            0,0,0,0,0,0,0,0,0,
            0,0,0,0,0,0,0,0,0,
            0,0,0,0,0,0,0,0,0,
            0,0,0,0,0,0,0,0,0,
            0,0,0,0,0,0,0,0,0,
            0,0,0,0,0,0,0,0,0,
            0,0,0,0,0,0,0,0,0,
            0,0,0,0,0,0,0,0,0
        ]
    },
    "collectable": ""
}
