{
    "data": {
        "moves": 30,
        "gems": [
            {
                "type": "coins",
                "amount": 25
            },
            {
                "type": "yellow",
                "amount": 25
            },
            {
                "type": "green",
                "amount": 25
            },
            {
                "type": "red",
                "amount": 25
            },
            {
                "type": "orange",
                "amount": 25
            }
        ],
        "objectives": [
            {
                "type": "climber",
                "amount": 2
            }
        ],
        "spawnRatioDroppable": {
            "gemColor": 0,
            "gemType": 0,
            "minSpawn": 0,
            "maxSpawn": 0,
            "probability": 0
        },
        "spawnRatios": [
            {
                "gemColor": 1,
                "gemType": 7,
                "minSpawn": 0,
                "maxSpawn": 1,
                "probability": 1
            },
            {
                "gemColor": 1,
                "gemType": 6,
                "minSpawn": 3,
                "maxSpawn": 6,
                "probability": 4
            }
        ],
        "hiddenItemName": "monkey"
    },
    "layout": {
        "fields": [
            1,1,1,1,1,1,1,1,1,
            2,1,1,1,1,1,1,1,1,
            1,2,1,1,1,1,1,1,1,
            1,1,2,1,1,1,1,1,1,
            1,1,1,2,1,1,1,1,1,
            1,1,1,1,1,1,1,1,1,
            1,1,1,1,1,1,1,1,1,
            1,1,1,1,1,1,1,1,1,
            1,1,1,1,1,1,1,1,1
        ],
        "tiles": [
            0,0,0,0,2,2,2,2,2,
            0,0,0,0,2,2,2,2,2,
            0,0,0,0,2,2,2,2,2,
            0,0,0,0,2,2,2,2,2,
            0,0,0,0,2,2,2,2,2,
            0,0,0,0,0,2,2,2,2,
            0,0,0,0,0,0,2,2,2,
            0,0,0,0,0,0,0,2,2,
            0,0,0,0,0,0,0,0,0
        ],
        "stones": [
            0,1,2,1,3,2,3,0,3,
            0,1,2,1,3,0,3,2,3,
            0,0,2,1,3,2,3,0,3,
            0,0,0,1,3,0,3,2,3,
            0,0,0,0,0,2,3,0,3,
            0,0,0,0,0,2,3,2,3,
            0,0,0,0,0,0,3,2,3,
            0,0,0,0,0,0,0,2,3,
            0,0,0,0,0,0,0,0,3
        ],
        "spawning": [
            1,1,1,1,1,1,1,1,1,
            0,0,0,0,0,0,0,0,0,
            0,0,0,0,0,0,0,0,0,
            0,0,0,0,0,0,0,0,0,
            0,0,0,0,0,0,0,0,0,
            0,0,0,0,0,0,0,0,0,
            0,0,0,0,0,0,0,0,0,
            0,0,0,0,0,0,0,0,0,
            0,0,0,0,0,0,0,0,0
        ],
        "dropItems": [
            0,0,0,0,0,0,0,0,0,
            0,0,0,0,0,0,0,0,0,
            0,0,0,0,0,0,0,0,0,
            0,0,0,0,0,0,0,0,0,
            0,0,0,0,0,0,0,0,0,
            0,0,0,0,0,0,0,0,0,
            0,0,0,0,0,0,0,0,0,
            0,0,0,0,0,0,0,0,0,
            0,0,0,0,0,0,0,0,0
        ],
        "chains": [
            0,0,0,0,0,0,0,0,0,
            0,0,0,0,0,0,0,0,0,
            0,0,0,0,0,0,0,0,0,
            0,0,0,0,0,0,0,0,0,
            0,0,0,0,0,0,0,0,0,
            0,0,0,0,0,0,0,0,0,
            0,0,0,0,0,0,0,0,0,
            0,0,0,0,0,0,0,0,0,
            0,0,0,0,0,0,0,0,0
        ],
        "hiddenItems": [
            0,0,0,0,0,0,0,5,5,
            0,0,0,0,6,6,0,5,5,
            0,0,0,0,6,6,0,0,0,
            0,0,0,0,0,0,7,7,0,
            0,0,0,0,0,0,7,7,0,
            0,0,0,0,0,0,0,0,0,
            0,0,0,0,0,0,0,1,1,
            0,0,0,0,0,0,0,1,1,
            0,0,0,0,0,0,0,0,0
        ],
        "gemColors": [
            8,0,0,0,0,0,0,1,0,
            0,0,0,0,0,1,0,0,0,
            8,0,0,0,0,0,0,1,0,
            8,8,0,0,0,1,0,0,0,
            8,1,8,0,12,0,0,1,0,
            8,8,8,8,0,0,0,0,0,
            8,8,8,8,8,0,0,0,0,
            8,1,8,8,2,6,0,0,0,
            8,8,8,4,8,1,1,0,0
        ],
        "gemTypes": [
            0,0,0,0,0,0,0,8,0,
            0,0,0,0,0,6,0,0,0,
            0,0,0,0,0,0,0,6,0,
            0,0,0,0,0,6,0,0,0,
            0,6,0,0,0,0,0,8,0,
            0,0,0,0,0,0,0,0,0,
            0,0,0,0,0,0,0,0,0,
            0,6,0,0,0,0,0,0,0,
            0,0,0,0,0,0,0,0,0
        ],
        "gemModifier": [
            0,0,0,0,0,0,0,0,0,
            0,0,0,0,0,0,0,0,0,
            0,0,0,0,0,0,0,0,0,
            0,0,0,0,0,0,0,0,0,
            0,0,0,0,0,0,0,0,0,
            0,0,0,0,0,0,0,0,0,
            0,0,0,0,0,0,0,0,0,
            0,0,0,0,0,0,0,0,0,
            0,0,0,0,0,0,0,0,0
        ],
        "portals": [
            0,0,0,0,0,0,0,0,0,
            0,0,0,0,0,0,0,0,0,
            0,0,0,0,0,0,0,0,0,
            0,0,0,0,0,0,0,0,0,
            0,0,0,0,0,0,0,0,0,
            0,0,0,0,0,0,0,0,0,
            0,0,0,0,0,0,0,0,0,
            0,0,0,0,0,0,0,0,0,
            0,0,0,0,0,0,0,0,0
        ],
        "crates": [
            0,0,0,0,0,0,0,0,0,
            0,0,0,0,0,0,0,0,0,
            0,0,0,0,0,0,0,0,0,
            0,0,0,0,0,0,0,0,0,
            0,0,0,0,0,0,0,0,0,
            0,0,0,0,0,0,0,0,0,
            0,0,0,0,0,0,0,0,0,
            0,0,0,0,0,0,0,0,0,
            0,0,0,0,0,0,0,0,0
        ],
        "climbers": [
            2,2,2,2,2,2,2,2,2,
            0,0,0,0,0,0,0,0,0,
            0,0,0,0,0,0,0,0,0,
            0,0,0,0,0,0,0,0,0,
            0,0,0,0,0,0,0,0,0,
            0,0,0,0,0,0,0,0,0,
            0,0,0,0,0,0,0,0,0,
            0,0,0,0,0,0,0,0,0,
            0,0,0,0,0,0,0,0,1
        ]
    },
    "collectable": ""
}
