{
    "data": {
        "moves": 25,
        "gems": [
            {
                "type": "coins",
                "amount": 25,
                "period": 0,
                "maxAmount": 0,
                "usage": 0
            },
            {
                "type": "blue",
                "amount": 25,
                "period": 0,
                "maxAmount": 0,
                "usage": 0
            },
            {
                "type": "green",
                "amount": 25,
                "period": 0,
                "maxAmount": 0,
                "usage": 0
            },
            {
                "type": "yellow",
                "amount": 25,
                "period": 0,
                "maxAmount": 0,
                "usage": 0
            },
            {
                "type": "red",
                "amount": 25,
                "period": 0,
                "maxAmount": 0,
                "usage": 0
            },
            {
                "type": "purple",
                "amount": 6,
                "period": 0,
                "maxAmount": 0,
                "usage": 0
            }
        ],
        "objectives": [
            {
                "type": "coins",
                "amount": 50,
                "period": 0,
                "maxAmount": 0,
                "usage": 0
            }
        ],
        "spawnRatioDroppable": {
            "gemColor": 0,
            "gemType": 0,
            "minSpawn": 0,
            "maxSpawn": 0,
            "probability": 0
        },
        "spawnRatios": [
            
        ],
        "hiddenItemName": "monkey"
    },
    "layout": {
        "fields": [
            1,1,1,1,1,1,1,1,1,
            1,1,1,1,1,1,1,1,1,
            1,1,1,1,1,1,1,1,1,
            1,1,1,1,1,1,1,1,1,
            1,1,1,1,1,1,1,1,1,
            1,1,1,1,1,1,1,1,1,
            1,1,1,1,1,1,1,1,1,
            1,1,1,1,1,1,1,1,1,
            1,1,1,1,1,1,1,1,1
        ],
        "tiles": [
            0,0,0,0,0,0,0,0,0,
            0,0,0,0,0,0,0,0,0,
            2,2,2,0,0,0,2,2,2,
            1,1,2,0,0,0,2,1,1,
            1,1,2,0,0,0,2,1,1,
            2,2,2,1,1,1,2,2,2,
            0,0,0,1,1,1,0,0,0,
            0,0,0,1,1,1,0,0,0,
            0,0,0,1,1,1,0,0,0
        ],
        "stones": [
            0,0,0,0,0,0,0,0,0,
            0,0,0,0,0,0,0,0,0,
            0,0,0,2,0,2,0,0,0,
            1,0,0,0,2,0,0,0,1,
            0,1,0,2,0,2,0,1,0,
            0,0,0,0,0,0,0,0,0,
            0,0,0,0,2,0,0,0,0,
            0,0,0,2,0,2,0,0,0,
            0,0,0,0,2,0,0,0,0
        ],
        "spawning": [
            1,1,1,1,1,1,1,1,1,
            0,0,0,0,0,0,0,0,0,
            0,0,0,0,0,0,0,0,0,
            0,0,0,0,0,0,0,0,0,
            0,0,0,0,0,0,0,0,0,
            0,0,0,0,0,0,0,0,0,
            0,0,0,0,0,0,0,0,0,
            0,0,0,0,0,0,0,0,0,
            0,0,0,0,0,0,0,0,0
        ],
        "dropItems": [
            0,0,0,0,0,0,0,0,0,
            0,0,0,0,0,0,0,0,0,
            0,0,0,0,0,0,0,0,0,
            0,0,0,0,0,0,0,0,0,
            0,0,0,0,0,0,0,0,0,
            0,0,0,0,0,0,0,0,0,
            0,0,0,0,0,0,0,0,0,
            0,0,0,0,0,0,0,0,0,
            0,0,0,0,0,0,0,0,0
        ],
        "chains": [
            0,0,0,0,0,0,0,0,0,
            0,0,0,0,0,0,0,0,0,
            1,1,1,0,0,0,1,1,1,
            0,0,1,0,0,0,1,0,0,
            0,0,1,0,0,0,1,0,0,
            1,1,1,1,1,1,1,1,1,
            0,0,0,0,0,0,0,0,0,
            0,0,0,0,0,0,0,0,0,
            0,0,0,0,0,0,0,0,0
        ],
        "hiddenItems": [
            0,0,0,0,0,0,0,0,0,
            0,0,0,0,0,0,0,0,0,
            0,0,0,0,0,0,0,0,0,
            5,5,0,0,0,0,0,6,6,
            5,5,0,0,0,0,0,6,6,
            0,0,0,0,0,0,0,0,0,
            0,0,0,1,1,1,0,0,0,
            0,0,0,1,1,1,0,0,0,
            0,0,0,1,1,1,0,0,0
        ],
        "gemColors": [
            8,8,8,8,8,8,8,8,8,
            8,8,8,8,8,8,8,8,8,
            8,8,8,0,8,0,8,8,8,
            0,10,8,8,0,10,8,10,0,
            8,0,8,0,8,0,8,0,10,
            8,8,8,8,8,8,8,8,8,
            0,0,0,10,0,8,0,0,0,
            0,0,0,0,8,0,0,0,0,
            0,0,0,8,0,10,0,0,0
        ],
        "gemTypes": [
            0,0,0,0,0,0,0,0,0,
            0,0,0,0,0,0,0,0,0,
            0,0,0,0,3,0,0,0,0,
            0,0,0,2,0,0,0,0,0,
            1,0,0,0,1,0,0,0,0,
            0,0,0,0,0,0,0,0,0,
            0,0,0,0,0,2,0,0,0,
            0,0,0,0,1,0,0,0,0,
            0,0,0,3,0,0,0,0,0
        ],
        "portals": [
            0,0,0,0,0,0,0,0,0,
            0,0,0,0,0,0,0,0,0,
            0,0,0,0,0,0,0,0,0,
            0,0,0,0,0,0,0,0,0,
            0,0,0,0,0,0,0,0,0,
            0,0,0,0,0,0,0,0,0,
            0,0,0,0,0,0,0,0,0,
            0,0,0,0,0,0,0,0,0,
            0,0,0,0,0,0,0,0,0
        ],
        "crates": [
            0,0,0,0,0,0,0,0,0,
            0,0,0,0,0,0,0,0,0,
            0,0,0,0,1,0,0,0,0,
            0,1,0,1,0,1,0,1,0,
            1,0,0,0,1,0,0,0,1,
            0,0,0,0,0,0,0,0,0,
            0,0,0,1,0,1,0,0,0,
            0,0,0,0,1,0,0,0,0,
            0,0,0,1,0,1,0,0,0
        ]
    },
    "collectable": ""
}
