{
    "data": {
        "moves": 23,
        "gems": [
            {
                "type": "coins",
                "amount": 25,
                "period": 0,
                "maxAmount": 0,
                "usage": 0
            },
            {
                "type": "blue",
                "amount": 25,
                "period": 0,
                "maxAmount": 0,
                "usage": 0
            },
            {
                "type": "green",
                "amount": 12,
                "period": 0,
                "maxAmount": 0,
                "usage": 0
            },
            {
                "type": "red",
                "amount": 25,
                "period": 0,
                "maxAmount": 0,
                "usage": 0
            },
            {
                "type": "orange",
                "amount": 25,
                "period": 0,
                "maxAmount": 0,
                "usage": 0
            }
        ],
        "objectives": [
            {
                "type": "orange",
                "amount": 60,
                "period": 0,
                "maxAmount": 0,
                "usage": 0
            },
            {
                "type": "red",
                "amount": 60,
                "period": 0,
                "maxAmount": 0,
                "usage": 0
            }
        ],
        "spawnRatioDroppable": {
            "gemColor": 0,
            "gemType": 0,
            "minSpawn": 0,
            "maxSpawn": 0,
            "probability": 0
        },
        "spawnRatios": [
            
        ],
        "hiddenItemName": "monkey"
    },
    "layout": {
        "fields": [
            0,1,1,1,1,1,1,1,0,
            0,1,1,1,1,1,1,1,0,
            0,1,1,1,1,1,1,1,0,
            0,0,1,1,1,1,1,0,0,
            0,0,0,1,1,1,0,0,0,
            0,0,0,1,1,1,0,0,0,
            0,1,1,1,1,1,1,1,0,
            1,1,1,1,1,1,1,1,1,
            1,1,1,1,1,1,1,1,1
        ],
        "tiles": [
            0,0,0,0,0,0,0,0,0,
            0,0,0,0,0,0,0,0,0,
            0,0,0,0,0,0,0,0,0,
            0,0,0,0,0,0,0,0,0,
            0,0,0,0,0,0,0,0,0,
            0,0,0,0,0,0,0,0,0,
            0,0,0,0,0,0,0,0,0,
            0,0,0,0,0,0,0,0,0,
            0,0,0,0,0,0,0,0,0
        ],
        "stones": [
            0,0,0,0,0,0,0,0,0,
            0,0,0,0,0,0,0,0,0,
            0,0,0,0,0,0,0,0,0,
            0,0,0,0,0,0,0,0,0,
            0,0,0,1,1,1,0,0,0,
            0,0,0,1,2,1,0,0,0,
            0,1,0,1,0,1,0,1,0,
            0,0,0,2,2,2,0,0,0,
            0,0,2,0,2,0,2,0,0
        ],
        "spawning": [
            0,1,1,1,1,1,1,1,0,
            0,0,0,0,0,0,0,0,0,
            0,0,0,0,0,0,0,0,0,
            0,0,0,0,0,0,0,0,0,
            0,0,0,0,0,0,0,0,0,
            0,0,0,0,0,0,0,0,0,
            0,1,0,0,0,0,0,1,0,
            0,0,0,0,0,0,0,0,0,
            0,0,0,0,0,0,0,0,0
        ],
        "dropItems": [
            0,0,0,0,0,0,0,0,0,
            0,0,0,0,0,0,0,0,0,
            0,0,0,0,0,0,0,0,0,
            0,0,0,0,0,0,0,0,0,
            0,0,0,0,0,0,0,0,0,
            0,0,0,0,0,0,0,0,0,
            0,0,0,0,0,0,0,0,0,
            0,0,0,0,0,0,0,0,0,
            0,0,0,0,0,0,0,0,0
        ],
        "chains": [
            0,0,0,0,0,0,0,0,0,
            0,0,0,0,0,0,0,0,0,
            0,0,0,0,0,0,0,0,0,
            0,0,1,1,1,1,1,0,0,
            0,0,0,0,0,0,0,0,0,
            0,0,0,0,0,0,0,0,0,
            0,0,0,0,0,0,0,0,0,
            0,0,0,0,0,0,0,0,0,
            0,0,0,0,0,0,0,0,0
        ],
        "hiddenItems": [
            0,0,0,0,0,0,0,0,0,
            0,0,0,0,0,0,0,0,0,
            0,0,0,0,0,0,0,0,0,
            0,0,0,0,0,0,0,0,0,
            0,0,0,0,0,0,0,0,0,
            0,0,0,0,0,0,0,0,0,
            0,0,0,0,0,0,0,0,0,
            0,0,0,0,0,0,0,0,0,
            0,0,0,0,0,0,0,0,0
        ],
        "gemColors": [
            0,8,8,8,8,8,8,8,0,
            0,8,8,8,8,8,8,8,0,
            0,8,8,8,8,8,8,8,0,
            0,0,8,8,8,8,8,0,0,
            0,0,0,0,0,0,0,0,0,
            0,0,0,0,0,0,0,0,0,
            0,0,0,0,8,0,0,0,0,
            0,0,0,0,0,0,0,0,0,
            0,0,0,6,0,1,0,0,0
        ],
        "gemTypes": [
            0,0,0,0,0,0,0,0,0,
            0,0,0,0,0,0,0,0,0,
            0,0,0,0,0,0,0,0,0,
            0,0,0,0,0,0,0,0,0,
            0,0,0,0,0,0,0,0,0,
            0,0,0,0,0,0,0,0,0,
            0,0,0,0,1,0,0,0,0,
            0,0,0,0,0,0,0,0,0,
            0,0,0,8,0,8,0,0,0
        ],
        "gemModifier": [
            
        ],
        "portals": [
            0,0,0,0,0,0,0,0,0,
            0,0,0,0,0,0,0,0,0,
            0,0,0,0,0,0,0,0,0,
            0,0,0,0,0,0,0,0,0,
            0,0,0,0,0,0,0,0,0,
            0,0,0,0,0,0,0,0,0,
            0,0,0,0,0,0,0,0,0,
            0,0,0,0,0,0,0,0,0,
            0,0,0,0,0,0,0,0,0
        ],
        "crates": [
            0,0,0,0,0,0,0,0,0,
            0,0,0,0,0,0,0,0,0,
            0,0,0,0,0,0,0,0,0,
            0,0,0,0,0,0,0,0,0,
            0,0,0,0,0,0,0,0,0,
            0,0,0,0,0,0,0,0,0,
            0,0,0,0,1,0,0,0,0,
            0,0,0,0,0,0,0,0,0,
            0,0,0,1,0,1,0,0,0
        ],
        "climbers": [
            
        ]
    },
    "collectable": ""
}
