{
    "data": {
        "moves": 36,
        "gems": [
            {
                "type": "coins",
                "amount": 25
            },
            {
                "type": "red",
                "amount": 25
            },
            {
                "type": "purple",
                "amount": 25
            },
            {
                "type": "green",
                "amount": 25
            },
            {
                "type": "blue",
                "amount": 11
            }
        ],
        "objectives": [
            
        ],
        "spawnRatioDroppable": {
            "gemColor": 0,
            "gemType": 0,
            "minSpawn": 0,
            "maxSpawn": 0,
            "probability": 0
        },
        "spawnRatios": [
            
        ],
        "hiddenItemName": "monkey"
    },
    "layout": {
        "fields": [
            1,1,0,1,1,1,1,1,1,
            1,1,0,1,1,1,1,1,1,
            1,1,0,1,0,1,1,0,1,
            1,1,0,1,1,1,1,1,1,
            1,1,0,1,1,1,1,1,1,
            1,1,0,1,1,1,1,1,1,
            1,1,0,1,1,1,1,1,1,
            1,1,0,1,1,1,1,1,1,
            1,1,0,1,1,1,1,1,1
        ],
        "tiles": [
            1,1,0,2,2,2,2,2,2,
            1,1,0,2,2,2,2,2,2,
            1,1,0,2,0,2,2,0,2,
            1,1,0,2,2,2,2,2,2,
            1,1,0,2,2,2,2,2,2,
            1,1,0,2,2,2,2,2,2,
            1,1,0,2,2,2,2,2,2,
            1,1,0,2,2,2,2,2,2,
            1,1,0,2,2,2,2,2,2
        ],
        "stones": [
            0,1,0,0,2,0,0,2,0,
            1,0,0,0,2,0,0,2,0,
            0,1,0,0,0,0,0,0,0,
            1,0,0,0,0,0,0,0,0,
            0,1,0,0,0,0,0,0,0,
            1,0,0,0,0,0,0,0,0,
            0,1,0,0,0,0,0,0,0,
            1,0,0,0,0,0,0,0,0,
            0,1,0,0,0,0,0,0,0
        ],
        "spawning": [
            1,1,0,1,1,1,1,1,1,
            0,0,0,0,0,0,0,0,0,
            0,0,0,0,0,0,0,0,0,
            0,0,0,0,0,0,0,0,0,
            0,0,0,0,0,0,0,0,0,
            0,0,0,0,0,0,0,0,0,
            0,0,0,0,0,0,0,0,0,
            0,0,0,0,0,0,0,0,0,
            0,0,0,0,0,0,0,0,0
        ],
        "dropItems": [
            0,0,0,0,0,0,0,0,0,
            0,0,0,0,0,0,0,0,0,
            0,0,0,0,0,0,0,0,0,
            0,0,0,0,0,0,0,0,0,
            0,0,0,0,0,0,0,0,0,
            0,0,0,0,0,0,0,0,0,
            0,0,0,0,0,0,0,0,0,
            0,0,0,0,0,0,0,0,0,
            0,0,0,0,0,0,0,0,0
        ],
        "chains": [
            0,0,0,0,0,0,0,0,0,
            0,0,0,0,0,0,0,0,0,
            0,0,0,0,0,0,0,0,0,
            0,0,0,0,0,0,0,0,0,
            0,0,0,0,0,0,0,0,0,
            0,0,0,0,0,0,0,0,0,
            0,0,0,0,0,0,0,0,0,
            0,0,0,0,0,0,0,0,0,
            0,0,0,0,0,0,0,0,0
        ],
        "hiddenItems": [
            0,0,0,2,2,0,0,1,1,
            0,0,0,2,2,0,0,1,1,
            0,0,0,0,0,0,0,0,0,
            0,0,0,0,0,0,0,0,0,
            0,0,0,0,0,0,0,0,0,
            0,0,0,0,5,5,5,5,0,
            0,0,0,0,5,5,5,5,0,
            3,3,0,0,5,5,5,5,0,
            3,3,0,0,5,5,5,5,0
        ],
        "gemColors": [
            13,0,0,8,0,8,8,0,8,
            0,13,0,8,0,8,8,0,8,
            13,0,0,8,0,8,8,0,8,
            0,13,0,8,8,8,8,8,8,
            13,0,0,13,13,13,13,13,13,
            0,13,0,8,8,8,8,8,8,
            13,0,0,8,8,8,8,8,8,
            0,13,0,13,13,13,13,13,13,
            13,0,0,8,8,8,8,8,8
        ],
        "gemTypes": [
            0,0,0,0,0,0,0,0,0,
            0,0,0,0,0,0,0,0,0,
            0,0,0,0,0,0,0,0,0,
            0,0,0,0,0,0,0,0,0,
            0,0,0,0,0,0,0,0,0,
            0,0,0,0,0,0,0,0,0,
            0,0,0,0,0,0,0,0,0,
            0,0,0,0,0,0,0,0,0,
            0,0,0,0,0,0,0,0,0
        ],
        "gemModifier": [
            4,0,0,0,0,0,0,0,0,
            0,4,0,0,0,0,0,0,0,
            4,0,0,0,0,0,0,0,0,
            0,4,0,0,0,0,0,0,0,
            4,0,0,5,5,5,5,5,5,
            0,4,0,0,0,0,0,0,0,
            4,0,0,0,0,0,0,0,0,
            0,4,0,5,5,5,5,5,5,
            4,0,0,0,0,0,0,0,0
        ],
        "portals": [
            0,0,0,0,0,0,0,0,0,
            0,0,0,0,0,0,0,0,0,
            0,0,0,0,0,0,0,0,0,
            0,0,0,0,0,0,0,0,0,
            0,0,0,0,0,0,0,0,0,
            0,0,0,0,0,0,0,0,0,
            0,0,0,0,0,0,0,0,0,
            0,0,0,0,0,0,0,0,0,
            0,0,0,0,0,0,0,0,0
        ],
        "crates": [
            0,0,0,0,0,0,0,0,0,
            0,0,0,0,0,0,0,0,0,
            0,0,0,0,0,0,0,0,0,
            0,0,0,0,0,0,0,0,0,
            0,0,0,0,0,0,0,0,0,
            0,0,0,0,0,0,0,0,0,
            0,0,0,0,0,0,0,0,0,
            0,0,0,0,0,0,0,0,0,
            0,0,0,0,0,0,0,0,0
        ],
        "climbers": [
            0,0,0,0,0,0,0,0,0,
            0,0,0,0,0,0,0,0,0,
            0,0,0,0,0,0,0,0,0,
            0,0,0,0,0,0,0,0,0,
            0,0,0,0,0,0,0,0,0,
            0,0,0,0,0,0,0,0,0,
            0,0,0,0,0,0,0,0,0,
            0,0,0,0,0,0,0,0,0,
            0,0,0,0,0,0,0,0,0
        ]
    },
    "collectable": ""
}
