{
    "data": {
        "moves": 38,
        "gems": [
            {
                "type": "coins",
                "amount": 25
            },
            {
                "type": "red",
                "amount": 25
            },
            {
                "type": "purple",
                "amount": 25
            },
            {
                "type": "green",
                "amount": 25
            },
            {
                "type": "blue",
                "amount": 10
            }
        ],
        "objectives": [
            {
                "type": "climber",
                "amount": 4
            }
        ],
        "spawnRatioDroppable": {
            "gemColor": 0,
            "gemType": 0,
            "minSpawn": 0,
            "maxSpawn": 0,
            "probability": 0
        },
        "spawnRatios": [
            
        ],
        "hiddenItemName": "monkey"
    },
    "layout": {
        "fields": [
            1,1,1,1,1,1,1,1,1,
            1,1,1,1,1,1,1,0,1,
            1,1,1,1,1,1,1,0,1,
            1,1,1,1,1,1,1,0,1,
            0,0,1,1,1,1,1,0,0,
            1,0,1,1,1,1,1,1,1,
            1,0,1,1,1,1,1,1,1,
            1,0,1,1,1,1,1,1,1,
            1,1,1,1,1,1,1,1,1
        ],
        "tiles": [
            0,0,0,0,0,0,0,0,0,
            0,0,0,0,0,0,0,0,0,
            0,0,0,0,0,0,0,0,0,
            0,0,0,0,0,0,0,0,0,
            0,0,0,0,0,0,0,0,0,
            0,0,0,0,0,0,0,0,0,
            0,0,0,0,0,0,0,0,0,
            0,0,0,0,0,0,0,0,0,
            0,0,0,0,0,0,0,0,0
        ],
        "stones": [
            0,0,0,0,0,0,0,0,0,
            0,0,0,0,0,0,0,0,0,
            8,0,0,0,0,0,0,0,0,
            0,0,0,0,8,0,0,0,0,
            0,0,0,0,0,0,0,0,0,
            0,0,0,0,8,0,0,0,0,
            0,0,0,0,0,0,0,0,8,
            0,0,0,0,0,0,0,0,0,
            0,0,0,0,0,0,0,0,0
        ],
        "spawning": [
            1,1,1,1,1,1,1,1,2,
            0,0,0,0,0,0,0,0,1,
            0,0,0,0,0,0,0,0,0,
            0,0,0,0,0,0,0,0,0,
            0,0,0,0,2,0,0,0,0,
            1,0,0,0,0,0,0,1,1,
            0,0,0,0,0,0,0,0,0,
            0,0,0,0,0,0,0,0,0,
            2,1,0,0,0,0,0,0,0
        ],
        "dropItems": [
            0,0,0,0,0,0,0,0,0,
            0,0,0,0,0,0,0,0,0,
            0,0,0,0,0,0,0,0,0,
            0,0,0,0,0,0,0,0,0,
            0,0,0,0,0,0,0,0,0,
            0,0,0,0,0,0,0,0,0,
            0,0,0,0,0,0,0,0,0,
            0,0,0,0,0,0,0,0,0,
            0,0,0,0,0,0,0,0,0
        ],
        "chains": [
            0,0,0,0,0,0,0,0,0,
            0,0,0,0,0,0,0,0,0,
            0,0,0,0,0,0,0,0,0,
            0,0,0,0,0,0,0,0,0,
            0,0,0,0,0,0,0,0,0,
            0,0,0,0,0,0,0,0,0,
            0,0,0,0,0,0,0,0,0,
            0,0,0,0,0,0,0,0,0,
            0,0,0,0,0,0,0,0,0
        ],
        "hiddenItems": [
            0,0,0,0,0,0,0,0,0,
            0,0,0,0,0,0,0,0,0,
            0,0,0,0,0,0,0,0,0,
            0,0,0,0,0,0,0,0,0,
            0,0,0,0,0,0,0,0,0,
            0,0,0,0,0,0,0,0,0,
            0,0,0,0,0,0,0,0,0,
            0,0,0,0,0,0,0,0,0,
            0,0,0,0,0,0,0,0,0
        ],
        "gemColors": [
            8,8,8,8,8,8,8,8,4,
            4,8,8,8,8,8,8,0,8,
            0,8,8,8,8,8,8,0,8,
            4,8,8,8,0,8,8,0,8,
            0,0,8,8,4,8,8,0,0,
            8,0,8,8,0,8,8,8,4,
            8,0,8,8,8,8,8,8,0,
            12,0,8,8,8,8,8,8,4,
            4,8,8,8,8,8,8,8,8
        ],
        "gemTypes": [
            0,0,0,0,0,0,0,0,6,
            7,0,0,0,0,0,0,0,0,
            0,0,0,0,0,0,0,0,0,
            7,0,0,0,0,0,0,0,0,
            0,0,0,0,9,0,0,0,0,
            0,0,0,0,0,0,0,0,7,
            0,0,0,0,0,0,0,0,0,
            0,0,0,0,0,0,0,0,7,
            6,0,0,0,0,0,0,0,0
        ],
        "gemModifier": [
            0,0,0,0,0,0,0,0,0,
            0,0,0,0,0,0,0,0,0,
            0,0,0,0,0,0,0,0,0,
            0,0,0,0,0,0,0,0,0,
            0,0,0,0,0,0,0,0,0,
            0,0,0,0,0,0,0,0,0,
            0,0,0,0,0,0,0,0,0,
            0,0,0,0,0,0,0,0,0,
            0,0,0,0,0,0,0,0,0
        ],
        "portals": [
            0,0,0,0,0,0,0,0,0,
            0,0,0,0,0,0,0,0,0,
            0,0,0,0,0,0,0,0,0,
            0,0,0,0,0,0,0,0,0,
            0,0,0,0,0,0,0,0,0,
            0,0,0,0,0,0,0,0,0,
            0,0,0,0,0,0,0,0,0,
            0,0,0,0,0,0,0,0,0,
            0,0,0,0,0,0,0,0,0
        ],
        "crates": [
            17,1,0,0,0,0,0,17,0,
            17,1,0,0,0,0,0,0,0,
            17,1,0,0,0,0,0,0,0,
            17,1,0,0,0,0,0,0,0,
            0,0,0,0,0,0,0,0,0,
            0,0,0,0,0,0,0,1,17,
            0,0,0,0,0,0,0,1,17,
            0,0,0,0,0,0,0,1,17,
            0,17,0,0,0,0,0,1,17
        ],
        "climbers": [
            0,0,0,0,0,0,0,0,0,
            0,0,0,0,0,0,0,0,2,
            0,0,0,0,0,0,0,0,0,
            0,0,0,0,0,0,0,0,1,
            0,0,0,0,0,0,0,0,0,
            2,0,0,0,0,0,0,0,0,
            0,0,0,0,0,0,0,0,0,
            1,0,0,0,0,0,0,0,0,
            0,0,0,0,0,0,0,0,0
        ]
    },
    "collectable": ""
}
