{
    "data": {
        "moves": 35,
        "gems": [
            {
                "type": "coins",
                "amount": 25
            },
            {
                "type": "red",
                "amount": 25
            },
            {
                "type": "orange",
                "amount": 25
            },
            {
                "type": "green",
                "amount": 25
            },
            {
                "type": "purple",
                "amount": 9
            }
        ],
        "objectives": [
            {
                "type": "orange",
                "amount": 150
            }
        ],
        "spawnRatioDroppable": {
            "gemColor": 0,
            "gemType": 0,
            "minSpawn": 0,
            "maxSpawn": 0,
            "probability": 0
        },
        "spawnRatios": [
            
        ],
        "hiddenItemName": "monkey"
    },
    "layout": {
        "fields": [
            1,1,1,1,0,0,1,1,1,
            1,1,1,1,0,0,1,1,1,
            1,1,1,1,0,1,1,1,1,
            1,1,1,1,1,1,1,1,1,
            1,1,1,1,1,1,1,1,1,
            1,1,1,0,0,1,1,1,1,
            1,1,1,0,0,1,1,1,1,
            1,1,1,0,0,0,1,1,1,
            1,1,1,0,0,0,1,1,1
        ],
        "tiles": [
            0,0,0,0,0,0,0,0,0,
            0,0,0,0,0,0,0,0,0,
            0,0,0,0,0,0,0,0,0,
            0,0,0,0,0,0,0,0,0,
            0,0,0,0,0,0,0,0,0,
            0,0,0,0,0,0,0,0,0,
            0,0,0,0,0,0,0,0,0,
            0,0,0,0,0,0,0,0,0,
            0,0,0,0,0,0,0,0,0
        ],
        "stones": [
            0,0,0,0,0,0,0,8,0,
            0,0,0,0,0,0,0,0,0,
            0,0,0,0,0,0,0,8,0,
            0,0,0,11,12,0,8,0,8,
            0,0,0,12,12,8,0,0,0,
            8,0,8,0,0,0,8,0,8,
            0,8,0,0,0,0,0,8,0,
            0,0,0,0,0,0,0,0,0,
            0,8,0,0,0,0,0,8,0
        ],
        "spawning": [
            1,1,1,1,0,0,0,1,0,
            0,0,0,0,0,0,0,0,0,
            0,0,0,0,0,0,0,0,0,
            0,0,0,0,0,0,0,0,0,
            0,0,0,0,0,0,0,0,0,
            0,0,0,0,0,0,0,0,0,
            0,0,0,0,0,0,0,0,0,
            0,0,0,0,0,0,0,0,0,
            0,0,0,0,0,0,0,0,0
        ],
        "dropItems": [
            0,0,0,0,0,0,0,0,0,
            0,0,0,0,0,0,0,0,0,
            0,0,0,0,0,0,0,0,0,
            0,0,0,0,0,0,0,0,0,
            0,0,0,0,0,0,0,0,0,
            0,0,0,0,0,0,0,0,0,
            0,0,0,0,0,0,0,0,0,
            0,0,0,0,0,0,0,0,0,
            0,0,0,0,0,0,0,0,0
        ],
        "chains": [
            0,0,0,0,0,0,0,0,0,
            0,0,0,0,0,0,0,0,0,
            0,0,0,0,0,0,0,0,0,
            0,0,0,0,0,0,0,0,0,
            0,0,0,0,0,0,0,0,0,
            0,0,0,0,0,0,0,0,0,
            0,0,0,0,0,0,0,0,0,
            0,0,0,0,0,0,0,0,0,
            0,0,0,0,0,0,0,0,0
        ],
        "hiddenItems": [
            0,0,0,0,0,0,0,0,0,
            0,0,0,0,0,0,0,0,0,
            0,0,0,0,0,0,0,0,0,
            0,0,0,0,0,0,0,0,0,
            0,0,0,0,0,0,0,0,0,
            0,0,0,0,0,0,0,0,0,
            0,0,0,0,0,0,0,0,0,
            0,0,0,0,0,0,0,0,0,
            0,0,0,0,0,0,0,0,0
        ],
        "gemColors": [
            8,8,8,8,0,0,8,0,6,
            8,8,8,8,0,0,8,6,8,
            8,8,8,8,0,8,8,0,8,
            8,8,8,0,0,6,0,6,0,
            8,8,8,0,0,0,8,8,6,
            0,6,0,0,0,6,0,6,0,
            8,0,8,0,0,8,8,0,8,
            8,6,8,0,0,0,8,6,8,
            8,0,8,0,0,0,6,0,8
        ],
        "gemTypes": [
            0,0,0,0,0,0,0,0,7,
            0,0,0,0,0,0,0,0,0,
            0,0,0,0,0,0,0,0,0,
            0,0,0,0,0,0,0,7,0,
            0,0,0,0,0,0,0,0,7,
            0,7,0,0,0,0,0,7,0,
            0,0,0,0,0,0,0,0,0,
            0,8,0,0,0,0,0,0,0,
            0,0,0,0,0,0,7,0,0
        ],
        "gemModifier": [
            0,0,0,2,0,0,2,0,2,
            0,0,0,0,0,0,0,2,0,
            0,0,0,2,0,0,1,0,1,
            0,0,0,0,0,1,0,3,0,
            0,0,0,0,0,0,0,1,0,
            0,2,0,0,0,1,0,3,0,
            3,0,3,0,0,0,1,0,1,
            2,0,2,0,0,0,0,2,0,
            3,0,3,0,0,0,2,0,2
        ],
        "portals": [
            0,0,0,0,0,0,4,0,2,
            0,0,0,0,0,0,0,0,0,
            0,0,0,0,0,0,0,0,0,
            0,0,0,0,0,0,0,0,0,
            0,0,0,0,0,0,0,0,0,
            0,0,0,0,0,0,0,0,0,
            0,0,0,0,0,0,0,0,0,
            0,0,0,0,0,0,0,0,0,
            3,0,1,0,0,0,0,0,0
        ],
        "crates": [
            0,0,0,0,0,0,0,27,0,
            0,0,0,26,0,0,25,0,25,
            0,0,0,0,0,25,0,0,0,
            0,0,0,0,0,0,0,0,0,
            0,0,0,0,0,27,10,0,27,
            0,0,0,0,0,0,0,0,0,
            0,0,0,0,0,25,0,0,0,
            0,11,0,0,0,0,25,0,25,
            0,0,0,0,0,0,0,27,0
        ],
        "climbers": [
            0,0,0,0,0,0,0,0,0,
            0,0,0,0,0,0,0,0,0,
            0,0,0,0,0,0,0,0,0,
            0,0,0,0,0,0,0,0,0,
            0,0,0,0,0,0,0,0,0,
            0,0,0,0,0,0,0,0,0,
            0,0,0,0,0,0,0,0,0,
            0,0,0,0,0,0,0,0,0,
            0,0,0,0,0,0,0,0,0
        ]
    },
    "collectable": ""
}
