{
    "data": {
        "moves": 31,
        "gems": [
            {
                "type": "coins",
                "amount": 25
            },
            {
                "type": "blue",
                "amount": 25
            },
            {
                "type": "orange",
                "amount": 25
            },
            {
                "type": "red",
                "amount": 25
            },
            {
                "type": "green",
                "amount": 9
            }
        ],
        "objectives": [
            {
                "type": "purple",
                "amount": 20
            }
        ],
        "spawnRatioDroppable": {
            "gemColor": 0,
            "gemType": 0,
            "minSpawn": 0,
            "maxSpawn": 0,
            "probability": 0
        },
        "spawnRatios": [
            
        ],
        "hiddenItemName": "monkey"
    },
    "layout": {
        "fields": [
            1,0,1,1,1,1,1,0,1,
            0,0,1,1,1,1,1,0,0,
            1,0,1,1,1,1,1,0,1,
            0,0,1,1,1,1,1,0,0,
            1,0,1,1,1,1,1,0,1,
            0,0,1,1,1,1,1,0,0,
            1,0,1,1,1,1,1,0,1,
            0,0,1,1,1,1,1,0,0,
            1,0,1,1,1,1,1,0,1
        ],
        "tiles": [
            0,0,2,2,0,2,2,0,0,
            0,0,2,2,0,2,2,0,0,
            0,0,2,2,1,2,2,0,0,
            0,0,2,2,1,2,2,0,0,
            0,0,2,2,1,2,2,0,0,
            0,0,2,2,1,2,2,0,0,
            0,0,2,2,1,2,2,0,0,
            0,0,2,2,0,2,2,0,0,
            0,0,2,2,0,2,2,0,0
        ],
        "stones": [
            0,0,3,0,0,0,3,0,0,
            0,0,0,0,1,0,0,0,0,
            0,0,0,0,0,0,0,0,0,
            0,0,0,0,2,0,0,0,0,
            0,0,3,0,0,0,3,0,0,
            0,0,0,0,2,0,0,0,0,
            0,0,0,0,0,0,0,0,0,
            0,0,0,0,1,0,0,0,0,
            0,0,3,0,0,0,3,0,0
        ],
        "spawning": [
            2,0,1,1,1,1,1,0,2,
            0,0,0,0,0,0,0,0,0,
            1,0,0,0,0,0,0,0,1,
            0,0,0,0,0,0,0,0,0,
            2,0,0,0,0,0,0,0,2,
            0,0,0,0,0,0,0,0,0,
            1,0,0,0,0,0,0,0,1,
            0,0,0,0,0,0,0,0,0,
            2,0,0,0,0,0,0,0,2
        ],
        "dropItems": [
            0,0,0,0,0,0,0,0,0,
            0,0,0,0,0,0,0,0,0,
            0,0,0,0,0,0,0,0,0,
            0,0,0,0,0,0,0,0,0,
            0,0,0,0,0,0,0,0,0,
            0,0,0,0,0,0,0,0,0,
            0,0,0,0,0,0,0,0,0,
            0,0,0,0,0,0,0,0,0,
            0,0,0,0,0,0,0,0,0
        ],
        "chains": [
            0,0,0,0,0,0,0,0,0,
            0,0,0,0,0,0,0,0,0,
            0,0,0,0,0,0,0,0,0,
            0,0,0,0,0,0,0,0,0,
            0,0,0,0,0,0,0,0,0,
            0,0,0,0,0,0,0,0,0,
            0,0,0,0,0,0,0,0,0,
            0,0,0,0,0,0,0,0,0,
            0,0,0,0,0,0,0,0,0
        ],
        "hiddenItems": [
            0,0,6,6,0,1,1,0,0,
            0,0,6,6,0,1,1,0,0,
            0,0,7,7,0,0,0,0,0,
            0,0,7,7,0,2,2,0,0,
            0,0,0,0,0,2,2,0,0,
            0,0,5,5,0,0,0,0,0,
            0,0,5,5,0,0,0,0,0,
            0,0,3,3,0,4,4,0,0,
            0,0,3,3,0,4,4,0,0
        ],
        "gemColors": [
            5,0,0,8,10,8,0,0,5,
            0,0,10,8,0,8,10,0,0,
            10,0,10,8,10,8,10,0,10,
            0,0,10,8,0,8,10,0,0,
            5,0,0,8,10,8,0,0,5,
            0,0,10,8,0,8,10,0,0,
            10,0,10,8,10,8,10,0,10,
            0,0,10,8,0,8,10,0,0,
            5,0,0,8,10,8,0,0,5
        ],
        "gemTypes": [
            1,0,0,0,0,0,0,0,1,
            0,0,0,0,0,0,0,0,0,
            0,0,0,0,0,0,0,0,0,
            0,0,0,0,0,0,0,0,0,
            1,0,0,0,0,0,0,0,1,
            0,0,0,0,0,0,0,0,0,
            0,0,0,0,0,0,0,0,0,
            0,0,0,0,0,0,0,0,0,
            1,0,0,0,0,0,0,0,1
        ],
        "gemModifier": [
            0,0,0,0,0,0,0,0,0,
            0,0,0,0,0,0,0,0,0,
            0,0,0,0,2,0,0,0,0,
            0,0,0,0,0,0,0,0,0,
            0,0,0,0,0,0,0,0,0,
            0,0,0,0,0,0,0,0,0,
            0,0,0,0,2,0,0,0,0,
            0,0,0,0,0,0,0,0,0,
            0,0,0,0,0,0,0,0,0
        ],
        "portals": [
            0,0,0,0,0,0,0,0,0,
            0,0,0,0,0,0,0,0,0,
            0,0,0,0,0,0,0,0,0,
            0,0,0,0,0,0,0,0,0,
            0,0,0,0,0,0,0,0,0,
            0,0,0,0,0,0,0,0,0,
            0,0,0,0,0,0,0,0,0,
            0,0,0,0,0,0,0,0,0,
            0,0,0,0,0,0,0,0,0
        ],
        "crates": [
            0,0,0,0,0,0,0,0,0,
            0,0,0,0,0,0,0,0,0,
            0,0,0,0,0,0,0,0,0,
            0,0,0,0,0,0,0,0,0,
            0,0,0,0,0,0,0,0,0,
            0,0,0,0,0,0,0,0,0,
            0,0,0,0,0,0,0,0,0,
            0,0,0,0,0,0,0,0,0,
            0,0,0,0,0,0,0,0,0
        ],
        "climbers": [
            0,0,0,0,0,0,0,0,0,
            0,0,0,0,0,0,0,0,0,
            0,0,0,0,0,0,0,0,0,
            0,0,0,0,0,0,0,0,0,
            0,0,0,0,0,0,0,0,0,
            0,0,0,0,0,0,0,0,0,
            0,0,0,0,0,0,0,0,0,
            0,0,0,0,0,0,0,0,0,
            0,0,0,0,0,0,0,0,0
        ]
    },
    "collectable": ""
}
